书名, rsk, fbr, fundy, note, employee, cassani, tytla, relational, calvano, future, amazon, washington, diamond, hacienda, ptolemy, pany, institutional, fense, arrendatario, goodyear, raa, sept, mina, network, tor, alfried, nishi, hayes, canada, telecommunication, libor, orts, procure, citibank, hsbc, nokia, diaper, environmental, issue, kildall, express, acadia, war, islamic, airmail, macgregor, primerica, acquisition, ebay, bmb, langford, director, hankey, lerner, dimon, walker, denys, maritimes, buxton, appeasement, public, annum, turbine, ltcm, loan, marissa, manber, united, volcker, village, bechtel, morgen, wilhelm, ruhr, publisher, eddie, adopter, malabo, trust, schueller, comstock, varley, boothe, jpmim, staa, recall, staveley, soviet, dez, sell, jonathan, detergent, version, mitchell, mcnulty, shelburne, calculator, nationalist, bay, flight, treasury, dobbs, corbis, chavez, malone, hauptverwaltungsgeb, melinda, arti, bond, shirley, adwords, complete, anheuser, bloc, queensland, prove, brin, gamble, aircraft, sheinberg, furnace, chevron, fugitive, vagliano, production, day, aerospace, amelio, votre, jetliner, harvard, olay, iphone, citi, airmotive, dumbo, miner, fintech, whitson, military, culp, colour, emilio, blankfein, deposition, facility, plan, broeksmit, holmes, porc, certi, crimson, morris, delprat, message, division, engine, titus, late, premium, copyright, mind, paschi, rcbc, antitrust, maersk, grant, actor, tax, minister, bertha, robinson, aig, opportunity, layoff, woolgar, theater, unilever, table, chairman, mcfarlane, department, delgado, remain, stratacom, plantbottle, kimberly, picture, scotian, journal, raburn, siegel, ton, manufacture, credit, heed, rubinstein, ibm, goal, prescott, supersonic, chase, copenhagen, lead, shaw, militia, delivery, laundering, bear, manufacturing, individual, contract, movie, characterise, influence, leuna, omaha, wiley, adelyn, card, nouville, costello, oscillator, packards, trial, abacus, airfreight, menzies, cream, whitehead, stearns, fountain, kola, organisational, iocs, parkin, feature, khodorkovsky, hardware, viscount, lessee, north, japan, ipo, phoenix, alstom, esplanaden, scottish, packard, goizueta, learn, generification, margarine, cheney, stock, morgridge, force, federation, lipp, societe, palestinian, volume, pretty, disney, disneyland, artzt, airplane, ivory, aguirre, land, initiative, softco, decade, metal, security, walk, billionaire, arabian, taylor, thiel, white, melchester, slocum, charmin, window, eduardo, flagler, jamaica, consent, image, confederation, action, valley, marine, insurer, river, shipowner, success, ancient, attempt, douglas, technology, commonwealth, cascara, ingres, country, support, quinn, insur, digital, involve, privateer, pixar, thornton, database, operating, lamont, package, cmb, cosmetic, concept, lockheedmartin, barger, range, cdo, tenenbaum, bakish, phrix, book, kloppers, salamon, energy, thecompany, george, switzerland, altavista, yarmouth, rhine, safir, tharsis, studio, barque, toynbee, obiang, aceh, diffcult, decision, derivative, fieldworker, british, melbourne, reserve, quantity, otc, manager, plantation, cecil, board, uggla, gdv, address, bunnell, railroad, beverage, metallorum, finland, character, bot, venture, snow, phix, vince, compute, chip, capm, kao, economic, reporter, vessel, sale, geico, pocantico, fine, facebook, bosch, leadership, oxford, exxonmobil, fourth, banesto, banker, solution, cassano, dreamliner, milner, tcg, nuremberg, fighter, dustin, ackermann, aktennote, kuisel, gutfreund, sculley, harbour, sandberg, schairer, telecom, emma, york, innovation, iraqi, ofthe, google, distribution, phantom, halifax, sutter, altair, kerr, mona, guadalcanal, toy, hewlett, wilke, plane, albuquerque, schmitt, idea, viniar, gustav, steve, bch, duly, saudi, fink, silicon, salon, school, weapon, lipton, key, babbitt, stanley, life, budweiser, dwarf, zalamea, eliza, bosack, nacchio, reagan, nixon, exec, guy, isaacson, follow, culture, kindle, indonesian, kimball, time, yahoo, beauty, defense, louisbourg, chief, kruppianer, spykes, finnish, fuselage, andalucia, farben, pams, guth, offit, elon, supervisoryboard, kindergarten, die, spelman, apartheid, currency, beaut, alzheimer, fortwashington, official, airbus, mouse, mnuchin, facemash, sbc, isdell, nigeria, kushner, cofield, photo, gross, air, client, hpers, pentagon, sthof, care, beit, rz, schlitz, sumner, lhe, leffingwell, galli, sandy, australia, karen, position, talk, peoplefirst, rock, barclays, reich, sidney, instagram, post, mtv, harman, operation, clydesdale, administrator, burlingame, lease, planning, augustine, saud, loyalist, frms, arabia, advertisement, social, champlain, hp, floor, france, madame, gun, traveler, indigo, walt, parker, stribs, levy, pnac, implementation, gas, putin, shampoo, overstreet, corporate, modi, speci, analysis, internet, chad, khaled, steele, zappos, inthe, bharat, food, edible, cubed, personal, mobil, trippe, soft, poutrincourt, faa, fred, offer, pepsi, nebraska, africa, brennan, towne, brunswick, bob, junior, athome, ellemann, brian, fleishman, scotia, ment, campaign, westervelt, fluoride, skill, organise, supply, macdonald, son, sharpsteen, leschly, gender, view, borsheims, camoys, tusa, balfour, iron, london, america, cola, street, lotus, nation, atari, quidsi, exist, england, hackborn, pendergrast, technological, inhabitant, deloncle, week, spain, gsam, experience, exhibit, mile, weill, history, bottler, park, grubman, rothstein, price, ordination, remisa, mike, philipp, manage, pampers, thain, union, rsi, grow, generic, salar, otml, schmidt, mussolini, lawyer, hispano, seattle, catholic, newfoundland, firm, phoenician, nally, cindy, citicorp, process, macintosh, decree, omid, steel, billiton, permanent, bhp, brewer, archbold, courier, kirkeby, sector, require, goldman, cohen, tailing, inbev, friedman, job, krupp, mclennan, hire, assessment, welch, arbitrage, smith, dutch, chamberlain, design, keryn, justine, india, requirement, tions, riyadh, sanz, aviation, customer, equity, northrop, misra, tarbell, immelt, team, study, turano, analyse, willumstad, president, sherin, ellison, serve, worldcom, rate, fowler, rosenfelder, yukos, nat, retailer, colgate, favour, geoghegan, account, wifi, artist, labour, unit, noski, berkowitz, staff, plant, tedi, barrett, fha, tillerson, centre, aulnay, wolastoqiyik, moonves, marietta, figueroa, davison, engage, kansa, midamerican, austin, program, hillard, atlantic, paper, jpmorgan, froogle, mrp, roy, buffett, denny, hongkong, robert, biplane, hobbs, liebert, memphis, mcdonnell, metre, bettencourt, risk, rumsfeld, denmark, fagan, bolze, news, rocket, assembly, corporation, clercq, metcalfe, foundation, engineer, frank, gusstahlfabrik, green, clark, power, china, pincus, level, instance, alizarin, raton, allianz, mail, giuliani, brock, industry, steagall, ballmer, bbva, matheson, elisha, dauman, nancing, arndt, gulliver, pert, built, arcy, preston, selborne, music, standardise, barrel, dye, rwm, canso, vrablic, conference, googlers, socal, weatherstone, town, schwede, chemical, novascotian, villard, specific, complex, ivester, profit, ariel, authority, earnings, pardon, penn, roosevelt, matt, pierpont, imperial, overrun, changa, israeli, basch, lord, tuck, apple, contact, focus, standard, water, nader, concession, zuckerberg, signi, sargen, university, edith, emery, fishery, rhodes, asset, lca, freston, terman, fitzgerald, cultural, dyestuff, fisher, oppau, neighbourhood, search, merchant, coke, redstones, viacom, girl, hair, occupation, empire, trader, practice, fly, lode, seashols, madrid, gate, visicalc, fort, people, competitor, nikora, germany, jew, catching, live, mintz, sort, lever, adrienne, latin, rich, improve, hangar, hathaway, distance, wolters, ovitz, dorm, paterson, kaphan, fedex, coburg, government, bbv, pictou, emphasise, bigvendor, senator, lifecycle, maye, aise, winkelman, abbey, precipitate, crisis, jacques, province, rasor, indictment, technet, shipper, english, advertiser, national, imbler, luis, sugar, bush, online, jassy, brewing, growth, alvy, tourre, amusement, osborne, acadian, letona, bycroft, bell, frydman, kmaq, functionality, update, cation, fahd, dollar, sail, kimbal, local, contractor, suria, tour, gmail, store, oehlert, cartoon, confederate, rhodesian, sokol, creative, dence, corzine, foreign, policyholder, luvs, fummi, capital, epcot, tesla, zapmail, agreement, katzenberg, eisner, ascertain, create, gwynne, netaid, hand, mendoza, lyttelton, shipment, share, sitzung, development, kennedy, bawtree, tci, nigerian, cab, refiner, midland, liliane, falcon, bomber, biography, black, concern, implement, finck, markkula, abdullah, technical, campus, ruin, egtvedt, advertising, environment, warner, consumption, australian, cooperman, family, valdez, exxon, iranian, raymond, candler, decide, french, startup, marius, lucas, league, nato, versicherungs, equatorial, innovative, middlevendor, provide, menschel, goudefroy, asiento, murray, colliery, abby, wireless, jorgensen, nortel, soul, biondi, service, animation, smallvendor, finance, venezuela, cameron, rasmussen, trading, finkelstein, airline, cobre, researcher, undoubtedly, commercial, chamber, armstrong, provincial, callon, pram, bgv, real, soldier, delsa, bornstein, increase, aca, car, mohammad, extradition, kmaw, branch, shearson, tiquet, viceroy, tarin, underwriter, private, eaect, amery, junius, annapolis, maughan, financial, lasseter, basic, staley, berlin, island, market, marketing, sevilla, bud, matter, relationship, exploration, tariki, klieger, rockefeller, sargenjpmorgan, strong, doty, office, hare, signet, cerro, senior, law, laurene, dilling, fre, edson, rimmer, inflation, mortgage, question, martino, shaft, prosecutor, kinney, swiss, model, climate, machine, deutsche, executive, user, winklevosses, offce, teel, tech, catto, feel, investor, mid, laundry, escoriae, fantasia, cauley, berthold, mandl, fed, base, citigroup, caffeine, mobile, supervisory, august, howe, fritz, packaging, doi, maxwell, meston, baptist, hilgard, brie, dbtca, joan, carnwath, tucker, administration, knowledge, collaborative, birnbaum, lehman, poul, escoriales, dalzell, prosperity, management, denise, supplier, hilltop, kirkland, lockheed, bambi, balliol, cementation, jsf, skin, setting, develop, organisation, vitriolized, analyst, coal, grenfell, svanholm, boston, cellular, ichauway, performance, munich, considerable, brand, deal, soap, cogan, dentifrice, gassee, jeeves, pecora, goto, frankfurt, netherlands, eug, ollila, iberian, boca, result, merger, feisal, left, leak, debt, canadian, underwriting, saracen, cagoule, litton, beer, college, azulay, eye, bottle, idestam, agius, wamu, space, indian, iwerks, berlind, arrive, transport, hindery, faissola, navy, takeover, cavanagh, crest, bevan, brunck, congress, nished, montebourg, hoechst, creativity, governor, exceptionally, federal, product, pdcg, spacex, browser, pantene, jeddah, missile, fitz, story, gartner, mediaone, scotians, wealth, speed, bezos, munger, wurster, reinsurance, animate, essen, proxmire, cincinnati, goschen, locality, oil, wozniak, forwarders, anshu, syrup, procurement, smale, diaerent, attorney, mineral, pinky, somers, company, data, oswald, aigfp, annual, keswick, indigenous, salisbury, cbs, wing, networking, morgan, lakeside, englanders, bank, merrill, masculinity, told, cloud, mitterrand, hub, explorer, moon, manuela, walter, ldc, city, airliner, rubin, nordic, dobkin, clinton, esher, jager, report, paramount, inktomi, haughton, effort, folk, foot, start, colleague, estelle, denazifcation, bayer, fife, sydney, sustainability, pete, juhayman, allen, electronics, jamie, barak, trump, adit, module, diet, fairbank, drainage, estes, seeger, economy, timeframes, adolphus, lab, meeting, woman, john, marc, respondent, community, judge, nancial, trudy, leader, communication, gel, irby, naimi, category, thefacebook, sacca, shareowner, astor, simonyi, church, animator, policy, mozer, commitment, council, typeface, prussian, shareholder, bohlen, centum, nerva, drink, stead, europe, brier, father, dorman, international, tinto, royal, pyrite, affair, include, curtis, sulphur, cettie, xto, pringles, agora, dominion, mci, german, investment, karmazin, drawing, launch, guinea, comdex, establish, condition, chapter, bought, loton, googleplex, seller, mark, lillian, month, purves, williams, flannery, nazi, bra, silver, whitacre, strategic, cargo, erent, gilbertson, imac, announcement, procter, tupper, magener, strategy, industrial, kid, derberg, jesselson, court, superfortress, major, colonial, vorstand, aramco, mickey, tide, huelva, avner, doetsch, redstone, spanish, vendor, email, county, termans, hirsch, harper, peabody, global, keyboard, offering, gussie, alfred, civic, european, king, quebec, cerent, mexico, jain, wesco, peninsula, freeman, love, nuclear, ship, maritime, danish, raskin, lobbying, stokowski, business, consumer, asia, ammonia, beitz, bittar, geddes, salomon, banking, favag, schacht, downsize, regime, rogers, engineering, guaranty, railway, catmull, secretary, pfs, cosmair, dave, greenhill, demont, balance, keller, satellite, customisation, refer, espa, divya, konzernherr, cape, situate, andr, colony, curzon, understand, cleveland, herrington, kairamo, miller, breton, serv, fulfillment, tyler, kearney, sqi, committee, kotchian, tomas, lending, farm, manufacturer, basf, iran, gencor, franc, fcc, ore, larry, gonzalo, stanford, busi, liverpool, flipkart, apollo, south, disposable, sagansky, mossad, boeing, fiorina, film, treaty, britain, obama, political, health, oracle, alta, friend, ipod, argus, pickup, partner, organization, building, doj, weinberg, prince, crown, ployees, transvaal, extract, microcomputer, troels, fund, drug, sants, escondida, clausen, lothian, banier, sanchez, pinocchio, cash, magma, software, glace, sibley, monsavon, release, copper, intellectual, settler, hoover, zeglis, william, hughes, hoare, settlement, louis, insurance, money, multiplan, winslow, cost, return, router, smelt, sachs, sulaiman, talulah, mining, jewish, arm, georgia, fieldwork, latour, elliott, cable, kottke, whitney, barney, pemberton, trade, form, susie, santander, roman, travel, cisco, socio, set, refinery, phone, konzern, galaroza, acadie, donnelly, dalle, overture, term, gasoline, wall, hour, portal, gabrielle, honour, busch, cardinal, port, yamani, transaction, coca, revivalhttps, restitution, arkansas, arroba, cocaine, explain, kaiser, approach, smut, schwim, middleton, institution, talley, winklevoss, zimmern, programmer, application, child, sergey, keough, benefit, socialist, artefact, medium, brent, jenkins, hitler, zankel, project, change, broadband, paris, iraq, region, jet, stis, martin, pilot, friedland, pro, mobira, rgensen, passenger, reed, party, walmart, art, feigin, scharf, context, berkshire, steinhubl, doerr, musk, determine, paulson, banco, alliance, american, phyllis, aracena, khomeini, regulator, house, bessie, period, timm, extraction, chadian, helena, toothpaste, ludwigshafen, friendster, commodity, brewery, vice, head, century, israel
Allianz and the German Insurance Business- 1933-1945 by Gerald D. Feldman, 0, 0, 0, 143, 166, 0, 0, 0, 0, 65, 0, 6, 1, 0, 0, 14, 3, 0, 0, 0, 185, 110, 0, 5, 18, 0, 0, 2, 0, 0, 0, 0, 9, 0, 0, 0, 0, 0, 209, 0, 63, 0, 383, 0, 0, 0, 0, 42, 0, 0, 0, 401, 0, 0, 0, 0, 0, 0, 0, 0, 151, 0, 0, 0, 33, 0, 0, 40, 1, 0, 0, 0, 38, 2, 1, 0, 0, 0, 12, 0, 0, 0, 0, 0, 0, 7, 0, 22, 94, 107, 1, 0, 10, 0, 0, 0, 0, 2, 9, 12, 9, 0, 0, 0, 0, 0, 0, 2, 41, 0, 0, 30, 0, 1, 0, 42, 0, 0, 0, 0, 2, 0, 0, 0, 19, 77, 0, 0, 0, 0, 0, 0, 0, 1, 0, 0, 0, 0, 0, 109, 0, 0, 0, 0, 0, 23, 148, 0, 0, 0, 0, 0, 0, 0, 9, 21, 0, 0, 82, 274, 1, 29, 0, 0, 0, 0, 34, 2, 79, 125, 0, 0, 0, 54, 0, 0, 0, 0, 16, 57, 0, 24, 0, 127, 0, 0, 0, 15, 0, 12, 0, 0, 1, 2, 45, 5, 0, 0, 67, 0, 0, 12, 1, 210, 0, 0, 2, 0, 24, 0, 66, 129, 0, 0, 0, 0, 0, 0, 0, 5, 0, 0, 0, 0, 20, 0, 0, 0, 1, 0, 0, 0, 0, 0, 0, 0, 6, 0, 0, 0, 0, 5, 0, 0, 0, 0, 0, 0, 0, 0, 25, 0, 0, 0, 21, 0, 128, 3, 0, 0, 0, 20, 1, 0, 0, 0, 2, 0, 0, 26, 23, 0, 16, 1, 71, 8, 0, 0, 0, 0, 11, 0, 0, 0, 19, 0, 0, 0, 0, 4, 0, 88, 0, 0, 295, 0, 0, 49, 0, 21, 0, 0, 0, 0, 0, 94, 130, 0, 83, 0, 185, 0, 0, 0, 0, 25, 0, 0, 0, 0, 3, 0, 0, 10, 0, 0, 0, 0, 26, 0, 0, 12, 0, 2, 49, 0, 0, 0, 0, 0, 0, 0, 0, 0, 0, 81, 120, 0, 0, 40, 0, 43, 2, 0, 17, 0, 1, 184, 0, 97, 12, 0, 4, 0, 0, 0, 31, 0, 4, 0, 87, 1, 0, 0, 0, 0, 270, 0, 1, 51, 0, 0, 0, 0, 3, 106, 5, 0, 6, 0, 30, 24, 0, 0, 0, 0, 15, 14, 0, 1, 68, 0, 0, 0, 0, 0, 0, 0, 0, 24, 0, 0, 6, 0, 5, 0, 0, 0, 0, 0, 0, 0, 0, 0, 0, 1, 0, 1167, 73, 0, 10, 0, 0, 6, 0, 0, 0, 0, 7, 4, 0, 14, 0, 1, 308, 0, 0, 0, 0, 0, 0, 0, 0, 2, 0, 0, 118, 13, 0, 0, 0, 421, 0, 0, 23, 0, 55, 0, 0, 3, 0, 0, 8, 0, 0, 0, 0, 0, 0, 275, 0, 0, 75, 0, 131, 0, 0, 0, 0, 0, 0, 0, 0, 0, 0, 0, 5, 2, 38, 16, 0, 0, 0, 27, 1, 91, 0, 0, 0, 0, 0, 0, 1, 0, 298, 12, 0, 3, 0, 576, 0, 0, 28, 0, 0, 49, 0, 6, 0, 1, 13, 0, 0, 1, 70, 0, 0, 68, 0, 0, 0, 80, 0, 1, 1, 0, 0, 0, 0, 16, 0, 23, 8, 0, 0, 0, 22, 0, 0, 18, 0, 0, 0, 0, 0, 0, 0, 15, 0, 0, 70, 0, 0, 0, 0, 1, 5, 84, 0, 0, 5, 0, 0, 0, 0, 1, 0, 0, 0, 0, 0, 62, 8, 0, 0, 16, 0, 14, 0, 38, 0, 0, 0, 200, 0, 0, 0, 0, 3, 23, 8, 0, 15, 0, 12, 0, 0, 83, 24, 0, 0, 1, 2, 0, 14, 12, 0, 48, 8, 0, 0, 60, 0, 1, 0, 0, 64, 0, 0, 0, 4, 64, 0, 0, 72, 0, 26, 0, 0, 0, 31, 1, 71, 0, 0, 4, 0, 0, 0, 3, 0, 0, 44, 0, 152, 0, 3, 0, 4, 0, 0, 0, 2, 0, 39, 96, 0, 0, 0, 0, 0, 44, 2, 0, 18, 9, 0, 0, 0, 28, 0, 26, 0, 0, 0, 26, 48, 0, 0, 4, 107, 4, 0, 0, 0, 0, 5, 40, 0, 0, 0, 48, 0, 0, 113, 0, 82, 0, 0, 0, 0, 0, 0, 0, 0, 144, 0, 2, 0, 5, 0, 0, 38, 58, 0, 0, 313, 0, 0, 0, 0, 0, 0, 0, 0, 55, 0, 0, 0, 65, 0, 1, 36, 0, 0, 0, 0, 0, 0, 0, 17, 0, 0, 0, 0, 0, 0, 0, 107, 0, 4, 0, 0, 21, 0, 3, 65, 0, 0, 9, 6, 19, 0, 0, 0, 91, 2, 0, 62, 27, 0, 0, 1771, 3, 0, 0, 320, 0, 0, 0, 0, 0, 0, 0, 0, 0, 1, 21, 0, 0, 0, 1, 0, 0, 0, 207, 0, 0, 17, 0, 0, 0, 3, 161, 2, 0, 0, 0, 12, 0, 0, 0, 153, 7, 2, 0, 1, 3, 0, 1, 1, 0, 0, 21, 1, 0, 0, 87, 4, 20, 9, 0, 25, 0, 0, 0, 16, 1, 0, 0, 1, 271, 0, 0, 0, 0, 2, 0, 0, 0, 0, 5, 10, 0, 0, 0, 1, 0, 49, 11, 0, 48, 0, 0, 0, 6, 2, 0, 8, 92, 17, 0, 315, 521, 0, 22, 0, 13, 0, 0, 0, 6, 18, 0, 0, 3, 0, 0, 0, 0, 0, 0, 161, 265, 0, 0, 0, 0, 5, 0, 0, 1, 0, 0, 0, 20, 1, 9, 0, 1, 0, 0, 69, 0, 334, 0, 0, 2, 0, 0, 0, 0, 12, 0, 0, 0, 0, 0, 0, 0, 1, 0, 0, 0, 2, 7, 0, 25, 0, 0, 23, 0, 0, 3, 0, 25, 0, 0, 0, 0, 0, 1, 4, 0, 209, 103, 0, 0, 63, 0, 0, 0, 121, 0, 0, 0, 132, 0, 0, 148, 0, 0, 7, 244, 46, 58, 0, 0, 0, 0, 0, 0, 0, 0, 0, 2, 1, 5, 365, 17, 83, 0, 0, 20, 0, 14, 0, 15, 5, 0, 2, 0, 0, 44, 0, 0, 0, 0, 0, 82, 146, 0, 0, 0, 38, 0, 91, 0, 0, 0, 198, 0, 69, 0, 0, 0, 0, 0, 0, 0, 4, 0, 110, 0, 0, 50, 0, 0, 0, 4, 0, 0, 0, 0, 31, 14, 11, 0, 1, 0, 0, 0, 78, 7, 0, 0, 156, 0, 4, 0, 0, 0, 213, 0, 0, 0, 0, 0, 343, 0, 0, 0, 0, 0, 1, 0, 55, 0, 339, 2, 66, 3, 0, 0, 202, 57, 0, 0, 0, 0, 0, 79, 0, 0, 0, 0, 0, 3, 193, 0, 0, 97, 0, 0, 0, 30, 296, 0, 0, 12, 0, 194, 27, 1, 29, 82, 39, 0, 0, 202, 0, 1, 0, 40, 1, 15, 1, 0, 0, 0, 0, 0, 12, 65, 0, 0, 2, 146, 103, 0, 14, 1, 0, 0, 0, 0, 933, 0, 0, 0, 0, 0, 32, 19, 0, 0, 0, 0, 0, 0, 0, 66, 0, 1, 0, 0, 0, 0, 0, 0, 0, 0, 0, 12, 8, 0, 0, 1, 0, 0, 1, 0, 0, 27, 398, 75, 1, 186, 1, 0, 0, 0, 0, 0, 0, 52, 30, 1, 0, 0, 0, 76, 10, 0, 78, 0, 26, 0, 0, 0, 0, 0, 1, 1, 0, 12, 0, 0, 0, 0, 8, 0, 0, 0, 8, 40, 0, 0, 0, 22, 0, 0, 0, 0, 4, 0, 0, 0, 2, 6, 1, 35, 23, 0, 0, 0, 0, 0, 0, 0, 10, 0, 0, 0, 5, 5, 0, 0, 0, 111, 0, 2, 0, 0, 0, 0, 1, 0, 0, 0, 0, 1, 0, 0, 3, 0, 0, 0, 1230, 2, 2, 0, 9, 0, 4, 0, 0, 15, 0, 0, 0, 0, 188, 0, 0, 72, 3, 0, 0, 0, 0, 0, 26, 0, 48, 0, 0, 1, 0, 0, 0, 0, 272, 0, 0, 0, 212, 0, 6, 19, 109, 0, 80, 0, 0, 0, 0, 0, 0, 0, 0, 0, 0, 0, 0, 0, 1, 0, 0, 0, 0, 127, 0, 0, 1, 246, 12, 3, 0, 0, 89, 7, 1, 0, 200, 3, 0, 0, 0, 35, 0, 0, 0, 0, 0, 9, 0, 725, 0, 15, 92, 0, 7, 47, 1, 0, 0, 0, 3, 34, 0, 18, 0, 61, 0, 2, 0, 53, 83, 0, 0, 0, 0, 0, 0, 0, 0, 921, 46, 0, 0, 22, 0, 0, 52, 125, 45, 25, 0, 0, 4, 74, 0, 60, 0, 0, 0, 237, 129, 1, 0, 3, 0, 0, 0, 0, 9, 0, 0, 0, 7, 34, 0, 0, 0, 146, 0, 83, 1, 4, 0, 0, 2, 0, 0, 0, 0, 17, 0, 1, 1, 0, 0, 0, 0, 5, 0, 10, 0, 22, 14, 29, 0, 0, 0, 0, 0, 0, 0, 0, 1, 0, 20, 1, 1, 0, 0, 0, 829, 7, 0, 0, 0, 0, 0, 0, 41, 116, 33, 0, 224, 0, 1, 0, 0, 0, 17, 1, 0, 0, 0, 0, 31, 0, 1, 0, 16, 0, 0, 0, 1, 0, 4, 0, 0, 57, 0, 0, 0, 0, 0, 2, 0, 0, 0, 0, 77, 0, 3, 1, 1, 1, 1, 1, 0, 29, 0, 0, 0, 0, 1, 34, 0, 0, 0, 25, 0, 0, 0, 0, 0, 1, 10, 3, 0, 178, 33, 0, 0, 58, 0, 0, 0, 9, 187, 106, 0, 0, 0, 3, 1, 0, 7, 0, 0, 58, 0, 0, 0, 0, 0, 0, 0, 0, 35, 0, 0, 0, 0, 0, 25, 0, 6, 1, 0, 0, 1, 0, 0, 67, 0, 2149, 108, 0, 0, 164, 92, 0, 1, 6, 0, 0, 1, 497, 8, 0, 0, 0, 0, 0, 0, 0, 0, 0, 33, 114, 0, 0, 0, 25, 0, 0, 103, 0, 2, 5, 0, 0, 0, 0, 1, 103, 0, 4, 19, 0, 0, 0, 1, 0, 25, 0, 4, 0, 0, 110, 0, 0, 0, 45, 1, 26, 0, 0, 0, 24, 0, 0, 0, 0, 3, 7, 0, 0, 0, 213, 0, 5, 0, 0, 221, 0, 29, 107, 0, 32, 1, 17, 0, 0, 38, 1, 0, 34, 0, 0, 0, 0, 362, 0, 8, 0, 0, 31, 0, 0, 0, 0, 35, 0, 0, 4, 109, 0, 0, 0, 4, 38, 0, 90, 0, 1, 0, 0, 0, 0, 0, 0, 3, 9, 162, 7, 8
Amazon-Unbound-Jeff-Bezos-and-the-Invention-of-a-Global-Empire-by-Stone_-Brad-_z-lib.org_, 0, 0, 0, 19, 328, 0, 0, 4, 0, 42, 1831, 78, 0, 0, 0, 0, 1, 0, 0, 0, 0, 0, 0, 43, 0, 0, 0, 1, 5, 2, 0, 0, 3, 0, 0, 0, 10, 7, 29, 0, 28, 0, 13, 0, 0, 0, 0, 29, 6, 0, 0, 37, 0, 0, 0, 0, 0, 0, 0, 0, 106, 0, 0, 0, 1, 0, 0, 7, 0, 1, 0, 0, 0, 0, 6, 1, 0, 0, 20, 0, 0, 0, 0, 0, 0, 66, 0, 0, 0, 112, 1, 2, 21, 1, 0, 0, 1, 0, 1, 16, 0, 0, 0, 0, 0, 0, 2, 0, 5, 0, 0, 8, 0, 0, 0, 20, 1, 3, 6, 0, 0, 0, 1, 0, 9, 212, 7, 0, 0, 0, 4, 0, 4, 0, 0, 0, 0, 0, 0, 7, 0, 0, 0, 0, 2, 26, 88, 0, 0, 0, 0, 0, 7, 0, 30, 52, 19, 0, 47, 13, 0, 22, 0, 0, 27, 1, 20, 15, 81, 6, 0, 1, 0, 41, 4, 0, 0, 2, 21, 9, 0, 34, 0, 49, 0, 0, 2, 14, 0, 19, 0, 0, 0, 2, 14, 1, 1, 5, 50, 0, 0, 2, 0, 47, 2, 0, 93, 0, 4, 2, 16, 48, 15, 0, 11, 0, 0, 0, 0, 17, 0, 0, 0, 0, 8, 0, 0, 0, 3, 0, 0, 0, 0, 0, 0, 0, 30, 0, 7, 0, 0, 20, 1, 1, 2, 0, 0, 0, 0, 0, 43, 0, 0, 0, 68, 0, 40, 0, 0, 0, 0, 13, 7, 4, 0, 0, 7, 0, 0, 19, 33, 0, 46, 3, 14, 50, 10, 1, 5, 1, 20, 0, 0, 0, 12, 0, 0, 0, 0, 29, 1, 10, 26, 2, 0, 1, 0, 31, 1, 20, 0, 96, 0, 0, 0, 74, 37, 1, 0, 25, 19, 0, 1, 1, 18, 28, 0, 44, 0, 1, 16, 0, 0, 7, 0, 0, 0, 0, 46, 0, 0, 15, 0, 15, 1, 0, 0, 0, 0, 0, 54, 0, 0, 0, 0, 0, 43, 0, 0, 2, 0, 6, 4, 0, 87, 0, 0, 31, 0, 0, 38, 0, 1, 0, 0, 0, 12, 0, 14, 2, 0, 0, 20, 4, 0, 0, 31, 24, 0, 90, 0, 0, 12, 17, 1, 37, 0, 0, 0, 0, 4, 16, 0, 0, 0, 0, 1, 0, 0, 0, 0, 0, 0, 0, 0, 1, 0, 2, 0, 87, 12, 0, 0, 66, 11, 0, 0, 0, 0, 0, 0, 0, 9, 0, 62, 16, 1, 0, 87, 0, 0, 23, 0, 0, 21, 0, 20, 2, 27, 2, 0, 16, 0, 0, 35, 0, 0, 0, 0, 0, 0, 2, 1, 85, 16, 0, 50, 30, 19, 0, 0, 305, 3, 3, 21, 0, 51, 0, 0, 0, 0, 0, 0, 0, 0, 0, 13, 0, 0, 9, 0, 0, 0, 0, 0, 0, 31, 0, 0, 0, 0, 0, 0, 0, 1, 0, 23, 3, 41, 8, 0, 5, 0, 20, 0, 0, 0, 0, 0, 0, 0, 0, 0, 0, 29, 77, 0, 2, 0, 0, 1, 2, 153, 1, 0, 62, 0, 0, 0, 13, 14, 0, 0, 0, 0, 9, 2, 25, 0, 0, 29, 7, 0, 3, 0, 0, 0, 0, 0, 5, 0, 0, 2, 0, 0, 0, 50, 12, 0, 8, 34, 0, 0, 0, 5, 0, 0, 75, 0, 0, 45, 0, 0, 3, 0, 2, 10, 54, 0, 0, 0, 2, 0, 0, 6, 3, 0, 0, 9, 0, 0, 0, 28, 0, 0, 9, 0, 30, 0, 16, 0, 0, 4, 40, 0, 0, 0, 0, 3, 5, 18, 1, 52, 0, 6, 0, 3, 13, 1, 0, 0, 5, 0, 0, 86, 5, 0, 37, 7, 23, 0, 33, 0, 9, 0, 0, 173, 0, 0, 21, 0, 32, 1, 0, 34, 0, 76, 5, 0, 0, 2, 0, 13, 0, 153, 0, 0, 52, 0, 0, 0, 0, 59, 0, 0, 0, 3, 0, 1, 0, 0, 0, 1, 0, 4, 32, 1, 2, 0, 0, 0, 84, 0, 0, 61, 2, 2, 1, 15, 2, 0, 23, 0, 1, 88, 8, 0, 0, 0, 5, 212, 3, 2, 0, 0, 0, 313, 8, 0, 0, 0, 71, 0, 3, 27, 0, 37, 0, 0, 0, 0, 37, 0, 0, 0, 36, 0, 4, 0, 29, 0, 0, 26, 9, 0, 0, 0, 0, 0, 0, 0, 1, 0, 0, 0, 16, 1, 0, 11, 66, 0, 3, 93, 0, 0, 0, 14, 4, 1, 0, 4, 0, 0, 0, 0, 0, 0, 0, 25, 0, 0, 0, 0, 58, 27, 1, 9, 0, 0, 4, 65, 1, 0, 4, 107, 34, 54, 0, 39, 2, 0, 0, 0, 4, 0, 0, 40, 0, 6, 0, 0, 0, 0, 0, 0, 0, 0, 20, 0, 5, 0, 24, 0, 1, 0, 0, 0, 0, 58, 0, 0, 0, 15, 0, 0, 0, 0, 10, 35, 0, 28, 0, 10, 11, 0, 1, 0, 7, 0, 0, 0, 0, 1, 0, 1, 1, 30, 14, 38, 26, 9, 0, 0, 8, 0, 0, 23, 0, 0, 0, 0, 3, 0, 0, 0, 0, 4, 0, 0, 0, 0, 90, 29, 4, 0, 0, 2, 4, 0, 14, 1, 25, 12, 0, 0, 0, 10, 0, 0, 125, 29, 0, 4, 1, 0, 18, 0, 15, 1, 0, 3, 7, 14, 0, 3, 13, 0, 0, 1, 0, 0, 26, 0, 48, 0, 0, 0, 0, 6, 0, 0, 0, 0, 1, 0, 11, 0, 0, 0, 0, 0, 1, 3, 13, 33, 0, 0, 1, 3, 73, 37, 0, 66, 0, 0, 0, 0, 0, 0, 0, 5, 0, 0, 1, 16, 0, 0, 38, 3, 0, 70, 7, 0, 18, 1, 130, 0, 0, 0, 0, 0, 8, 0, 0, 13, 0, 0, 0, 20, 0, 10, 0, 16, 0, 0, 1, 61, 2, 0, 43, 0, 0, 3, 47, 0, 52, 1, 0, 0, 0, 1, 0, 0, 0, 5, 0, 1, 25, 13, 5, 0, 0, 0, 29, 7, 2, 0, 60, 20, 1, 1, 2, 0, 51, 33, 0, 4, 0, 0, 30, 7, 41, 0, 0, 3, 0, 0, 0, 8, 0, 24, 0, 0, 0, 0, 0, 0, 7, 2, 0, 1, 0, 131, 0, 0, 22, 1, 2, 0, 1, 0, 8, 0, 1, 2, 16, 3, 0, 0, 0, 0, 0, 28, 1, 0, 0, 52, 0, 11, 0, 0, 0, 0, 0, 0, 0, 0, 0, 79, 0, 0, 0, 0, 0, 38, 0, 7, 0, 3, 14, 90, 13, 0, 0, 33, 53, 4, 0, 0, 0, 0, 14, 0, 99, 4, 0, 0, 55, 28, 0, 0, 0, 0, 0, 1, 0, 83, 0, 0, 6, 0, 0, 28, 20, 14, 0, 228, 22, 0, 0, 0, 54, 0, 20, 40, 11, 1, 0, 0, 0, 0, 0, 4, 65, 0, 0, 8, 0, 18, 0, 0, 7, 0, 0, 0, 0, 0, 0, 0, 0, 0, 0, 9, 9, 0, 0, 0, 0, 0, 0, 0, 29, 0, 12, 0, 1, 2, 0, 0, 0, 0, 1, 0, 38, 0, 0, 10, 0, 0, 0, 12, 0, 0, 26, 1, 6, 82, 67, 0, 0, 0, 0, 0, 0, 0, 1, 0, 0, 0, 0, 0, 95, 6, 0, 43, 6, 1, 3, 0, 0, 0, 0, 1, 10, 0, 17, 10, 0, 0, 0, 88, 27, 0, 0, 6, 11, 0, 0, 1, 0, 0, 0, 0, 0, 10, 0, 0, 0, 1, 10, 0, 18, 211, 0, 27, 0, 0, 0, 1, 0, 75, 0, 0, 0, 19, 13, 1012, 0, 0, 0, 2, 1, 0, 3, 0, 1, 3, 0, 0, 0, 1, 4, 0, 0, 13, 0, 0, 0, 605, 87, 0, 0, 51, 0, 1, 0, 3, 5, 1, 1, 0, 0, 3, 0, 0, 106, 34, 0, 14, 3, 10, 0, 1, 0, 163, 0, 0, 0, 0, 0, 0, 0, 95, 1, 0, 0, 48, 4, 34, 156, 87, 0, 0, 0, 0, 0, 0, 0, 0, 11, 13, 0, 0, 72, 0, 0, 3, 0, 0, 0, 0, 11, 0, 0, 15, 139, 11, 19, 6, 0, 30, 7, 0, 0, 57, 14, 0, 0, 0, 25, 0, 0, 1, 0, 0, 3, 0, 27, 0, 4, 29, 0, 0, 16, 0, 0, 0, 3, 0, 16, 0, 12, 0, 25, 0, 1, 0, 20, 79, 0, 0, 0, 0, 1, 0, 0, 0, 10, 51, 0, 0, 73, 2, 0, 26, 12, 17, 19, 0, 0, 133, 26, 0, 115, 0, 7, 0, 0, 0, 0, 0, 7, 8, 0, 0, 0, 14, 3, 0, 0, 20, 5, 13, 0, 0, 15, 0, 26, 0, 0, 0, 0, 0, 0, 0, 0, 0, 2, 18, 76, 8, 0, 0, 0, 0, 32, 1, 18, 0, 0, 0, 10, 5, 0, 0, 36, 1, 0, 0, 1, 32, 0, 19, 0, 1, 0, 3, 0, 232, 28, 1, 0, 0, 0, 0, 0, 0, 0, 0, 1, 3, 2, 12, 0, 0, 0, 5, 0, 0, 26, 0, 0, 6, 0, 12, 0, 7, 0, 0, 0, 2, 0, 0, 2, 0, 24, 1, 48, 0, 0, 0, 0, 50, 0, 0, 0, 16, 0, 0, 3, 1, 7, 0, 1, 0, 0, 0, 0, 4, 0, 2, 0, 0, 57, 4, 20, 1, 0, 0, 11, 0, 36, 0, 0, 7, 53, 15, 15, 0, 32, 0, 0, 1, 33, 29, 65, 1, 0, 7, 7, 0, 0, 2, 0, 0, 28, 2, 0, 0, 0, 0, 0, 90, 0, 20, 0, 26, 0, 0, 0, 27, 0, 3, 0, 0, 0, 3, 2, 0, 2, 1, 4, 40, 0, 0, 72, 54, 0, 0, 1, 0, 0, 0, 2, 13, 5, 0, 0, 1, 9, 0, 0, 0, 0, 12, 16, 0, 0, 0, 33, 0, 0, 85, 0, 84, 0, 0, 0, 0, 0, 0, 41, 1, 36, 61, 0, 0, 0, 0, 0, 1, 0, 7, 1, 0, 0, 1, 0, 0, 23, 0, 41, 0, 0, 1, 8, 0, 0, 0, 0, 7, 21, 1, 0, 16, 1, 0, 71, 0, 0, 0, 0, 117, 93, 3, 3, 0, 11, 9, 0, 2, 18, 0, 2, 0, 0, 3, 3, 80, 39, 7, 0, 0, 1, 3, 0, 0, 34, 15, 0, 0, 3, 22, 0, 0, 0, 12, 36, 0, 10, 0, 0, 0, 0, 0, 0, 0, 2, 0, 54, 45, 12, 2
At-the-Oceans-Edge-A-History-of-Nova-Scotia-to-Confederation-_Studies-in-Atlantic-Canada-History_-by_1, 0, 0, 51, 23, 9, 0, 0, 0, 0, 16, 0, 13, 0, 0, 0, 0, 4, 0, 0, 0, 0, 0, 15, 6, 0, 0, 0, 0, 195, 0, 0, 0, 1, 0, 0, 0, 0, 4, 61, 0, 11, 15, 245, 0, 0, 7, 0, 0, 0, 0, 0, 5, 0, 0, 0, 1, 29, 82, 1, 0, 73, 1, 0, 0, 7, 0, 0, 129, 0, 6, 0, 0, 0, 0, 3, 0, 0, 0, 2, 0, 0, 0, 0, 0, 0, 4, 0, 0, 0, 47, 11, 0, 5, 2, 0, 21, 0, 1, 78, 2, 7, 0, 0, 0, 0, 0, 0, 0, 0, 6, 0, 17, 0, 2, 0, 48, 0, 4, 0, 0, 0, 0, 1, 0, 20, 73, 0, 0, 0, 0, 5, 0, 0, 0, 0, 0, 13, 0, 0, 104, 0, 9, 0, 0, 1, 9, 57, 0, 3, 0, 0, 0, 12, 0, 7, 8, 5, 1, 40, 1, 0, 17, 0, 0, 0, 0, 128, 0, 29, 71, 0, 1, 0, 56, 0, 0, 0, 0, 20, 0, 1, 4, 0, 119, 0, 0, 0, 2, 14, 6, 0, 0, 5, 15, 8, 1, 0, 0, 30, 3, 0, 10, 0, 87, 2, 52, 2, 0, 19, 9, 20, 17, 2, 0, 34, 0, 0, 0, 0, 1, 0, 0, 0, 0, 6, 0, 0, 0, 0, 2, 0, 0, 0, 0, 0, 1, 14, 0, 1, 1, 0, 296, 0, 0, 0, 0, 0, 32, 0, 0, 30, 0, 0, 0, 6, 0, 116, 9, 0, 0, 0, 11, 0, 0, 0, 0, 0, 1, 0, 173, 52, 0, 47, 6, 11, 10, 0, 0, 1, 0, 36, 0, 0, 0, 3, 0, 0, 3, 2, 10, 79, 16, 22, 22, 0, 90, 0, 36, 11, 32, 1, 13, 2, 0, 0, 69, 137, 0, 0, 1, 31, 22, 0, 0, 0, 8, 0, 1, 0, 0, 5, 0, 0, 20, 0, 0, 0, 0, 16, 0, 0, 15, 0, 54, 1, 0, 26, 0, 0, 0, 0, 1, 0, 0, 0, 0, 24, 0, 0, 398, 1, 19, 5, 0, 8, 9, 0, 48, 0, 0, 29, 0, 1, 2, 0, 0, 8, 0, 23, 7, 0, 0, 0, 2, 0, 0, 63, 0, 113, 12, 0, 0, 19, 0, 0, 13, 6, 0, 6, 0, 2, 8, 0, 0, 0, 0, 0, 3, 0, 0, 0, 0, 0, 0, 58, 0, 0, 0, 2, 39, 4, 0, 0, 0, 4, 0, 383, 0, 0, 0, 0, 0, 1, 0, 1, 0, 0, 0, 28, 0, 0, 0, 0, 0, 0, 0, 0, 0, 96, 6, 0, 6, 0, 1, 81, 0, 0, 0, 3, 0, 0, 0, 0, 0, 2, 0, 127, 44, 0, 0, 0, 188, 0, 1, 0, 91, 52, 0, 0, 0, 0, 0, 0, 0, 0, 0, 0, 0, 0, 42, 0, 0, 13, 0, 0, 0, 57, 0, 2, 0, 0, 0, 0, 0, 0, 0, 0, 2, 10, 1, 0, 0, 0, 15, 0, 0, 0, 0, 0, 0, 0, 0, 3, 0, 84, 11, 0, 5, 0, 0, 0, 0, 40, 0, 0, 30, 0, 20, 0, 10, 4, 0, 0, 114, 0, 0, 0, 48, 26, 0, 3, 179, 9, 6, 0, 1, 0, 0, 0, 6, 0, 0, 3, 0, 0, 0, 4, 0, 0, 4, 1, 0, 0, 0, 0, 0, 0, 27, 0, 0, 18, 0, 0, 4, 15, 0, 0, 108, 0, 0, 13, 0, 0, 80, 0, 1, 0, 0, 3, 0, 621, 0, 36, 0, 0, 25, 0, 78, 35, 94, 0, 0, 13, 23, 0, 0, 0, 0, 16, 61, 176, 0, 34, 0, 40, 0, 0, 6, 172, 0, 0, 2, 37, 0, 22, 16, 0, 43, 4, 9, 0, 49, 0, 5, 0, 0, 20, 3, 0, 0, 0, 69, 0, 0, 124, 0, 48, 0, 0, 0, 0, 0, 14, 0, 0, 105, 66, 7, 0, 0, 0, 0, 36, 0, 1, 0, 2, 0, 19, 0, 1, 0, 0, 0, 1, 42, 0, 0, 0, 0, 0, 17, 0, 0, 16, 7, 0, 0, 21, 15, 0, 36, 0, 0, 5, 1, 0, 0, 0, 0, 1, 0, 0, 0, 0, 0, 2, 19, 0, 2, 0, 17, 0, 0, 127, 0, 11, 1, 0, 0, 0, 0, 0, 22, 0, 25, 0, 7, 31, 9, 0, 0, 1, 20, 0, 0, 0, 0, 21, 24, 32, 0, 0, 0, 0, 23, 0, 0, 0, 11, 0, 156, 15, 0, 0, 0, 2, 0, 1, 0, 27, 0, 0, 0, 0, 0, 4, 0, 7, 0, 0, 0, 0, 5, 0, 141, 3, 32, 0, 10, 9, 3, 0, 9, 2, 84, 0, 0, 45, 6, 0, 0, 0, 8, 0, 0, 30, 0, 0, 0, 0, 0, 0, 0, 0, 0, 0, 44, 2, 15, 0, 3, 0, 13, 2, 0, 53, 0, 15, 0, 0, 0, 86, 0, 0, 6, 0, 4, 3, 0, 25, 0, 92, 1, 4, 0, 1, 0, 0, 35, 1, 0, 0, 0, 30, 2, 3, 38, 34, 20, 53, 0, 14, 0, 0, 0, 25, 1, 0, 76, 1, 2, 0, 0, 0, 0, 30, 0, 6, 0, 2, 12, 94, 1, 0, 0, 16, 9, 19, 52, 16, 61, 3, 0, 0, 1, 0, 0, 90, 267, 5, 0, 1, 3, 0, 70, 0, 9, 0, 0, 1, 13, 34, 0, 0, 10, 0, 0, 0, 0, 0, 0, 0, 231, 0, 68, 0, 0, 4, 0, 0, 1, 0, 0, 5, 19, 10, 205, 0, 1, 0, 18, 80, 1, 25, 0, 0, 16, 0, 2, 0, 1, 21, 0, 0, 2, 0, 200, 0, 0, 3, 0, 222, 0, 0, 0, 0, 5, 43, 0, 99, 0, 0, 70, 0, 7, 0, 1, 56, 0, 0, 5, 0, 0, 20, 0, 0, 0, 36, 0, 0, 0, 41, 0, 0, 0, 52, 0, 0, 36, 0, 0, 1, 39, 0, 38, 2, 0, 0, 0, 0, 0, 0, 0, 0, 0, 0, 88, 14, 10, 0, 0, 0, 0, 0, 6, 0, 0, 12, 0, 9, 0, 0, 149, 0, 0, 0, 1, 0, 25, 231, 0, 0, 0, 13, 0, 0, 0, 2, 0, 70, 0, 0, 0, 2, 2, 0, 0, 0, 0, 11, 0, 41, 0, 0, 19, 0, 0, 0, 46, 0, 0, 0, 0, 2, 40, 9, 1, 76, 0, 0, 0, 8, 105, 0, 0, 37, 0, 0, 0, 0, 30, 15, 0, 0, 2, 0, 0, 29, 0, 0, 0, 82, 0, 24, 0, 7, 0, 0, 141, 48, 1, 0, 0, 44, 16, 11, 0, 0, 0, 0, 16, 0, 53, 1, 0, 0, 2, 57, 0, 0, 0, 0, 0, 0, 1, 31, 0, 0, 0, 0, 4, 6, 24, 3, 0, 19, 0, 0, 0, 0, 0, 0, 3, 6, 43, 0, 0, 0, 0, 0, 0, 2, 109, 0, 0, 7, 0, 19, 144, 0, 0, 0, 0, 0, 54, 0, 0, 0, 0, 0, 0, 23, 21, 0, 0, 0, 0, 0, 0, 8, 1, 0, 3, 0, 0, 0, 0, 0, 0, 0, 22, 0, 22, 0, 0, 0, 59, 0, 0, 95, 0, 0, 3, 0, 10, 2, 17, 3, 0, 0, 0, 0, 0, 0, 0, 4, 0, 0, 2, 0, 70, 0, 0, 44, 2, 21, 94, 0, 0, 0, 0, 5, 41, 0, 21, 6, 0, 0, 0, 12, 34, 0, 0, 97, 13, 0, 0, 27, 0, 0, 0, 0, 0, 8, 0, 0, 0, 0, 153, 4, 56, 23, 0, 0, 0, 0, 0, 0, 0, 18, 0, 0, 92, 19, 4, 0, 0, 0, 0, 7, 0, 0, 0, 0, 1, 17, 0, 0, 0, 0, 0, 0, 0, 8, 12, 0, 0, 73, 0, 0, 0, 18, 0, 113, 1, 0, 4, 1, 0, 0, 43, 25, 0, 0, 9, 2, 0, 5, 8, 6, 0, 4, 0, 46, 0, 0, 3, 0, 0, 0, 0, 84, 0, 0, 0, 115, 8, 24, 9, 5, 0, 0, 0, 0, 35, 0, 0, 0, 1, 0, 0, 0, 1, 0, 0, 7, 0, 0, 0, 0, 41, 0, 0, 0, 42, 138, 216, 3, 2, 169, 13, 0, 0, 58, 17, 0, 0, 0, 4, 0, 0, 0, 0, 0, 159, 0, 84, 0, 7, 112, 0, 1, 1, 0, 0, 0, 7, 0, 41, 2, 51, 0, 18, 0, 214, 0, 22, 155, 0, 0, 0, 0, 0, 0, 24, 0, 20, 20, 0, 2, 26, 1, 0, 161, 59, 20, 2, 0, 0, 0, 13, 0, 33, 0, 9, 0, 0, 4, 4, 0, 8, 13, 0, 0, 0, 3, 0, 101, 0, 27, 38, 0, 0, 0, 56, 0, 75, 121, 0, 0, 0, 13, 0, 0, 0, 0, 23, 0, 0, 95, 0, 0, 6, 0, 20, 0, 6, 0, 1, 2, 184, 95, 112, 0, 7, 0, 0, 12, 0, 3, 0, 119, 122, 0, 0, 1, 0, 41, 8, 6, 0, 0, 0, 0, 0, 12, 0, 0, 0, 13, 1, 1, 0, 77, 0, 25, 0, 0, 0, 0, 0, 17, 1, 0, 0, 7, 0, 0, 0, 133, 4, 0, 248, 0, 13, 0, 0, 0, 2, 120, 0, 0, 0, 0, 0, 13, 0, 0, 0, 47, 1, 0, 0, 0, 0, 0, 1, 0, 0, 0, 0, 21, 0, 0, 35, 0, 0, 0, 0, 0, 2, 71, 118, 0, 124, 8, 0, 0, 23, 0, 0, 0, 23, 16, 40, 0, 0, 50, 31, 0, 0, 6, 0, 0, 21, 2, 0, 0, 0, 0, 0, 0, 0, 5, 0, 0, 0, 0, 0, 15, 4, 12, 127, 0, 0, 116, 0, 0, 75, 52, 2, 39, 0, 8, 22, 110, 0, 1, 0, 0, 0, 14, 0, 36, 6, 1, 1, 4, 1, 0, 0, 0, 0, 175, 53, 0, 0, 53, 32, 0, 0, 50, 1, 0, 0, 0, 126, 0, 0, 4, 55, 0, 15, 12, 1, 0, 12, 0, 4, 176, 0, 2, 0, 0, 1, 0, 0, 0, 22, 0, 34, 0, 0, 0, 43, 0, 0, 0, 0, 2, 91, 0, 0, 20, 0, 6, 2, 0, 1, 0, 0, 25, 40, 0, 23, 0, 214, 0, 0, 5, 3, 0, 0, 0, 0, 16, 1, 75, 0, 7, 0, 0, 19, 0, 0, 0, 0, 69, 0, 0, 22, 201, 0, 0, 0, 0, 84, 0, 69, 0, 1, 0, 0, 0, 0, 0, 12, 1, 12, 37, 168, 1
Bill  Dave How Hewlett and Packard Built the World’s Greatest Company by Michael S. Malone (z-lib.org), 0, 85, 0, 69, 362, 0, 0, 0, 0, 92, 1, 45, 0, 0, 0, 1, 8, 0, 0, 0, 0, 0, 0, 22, 0, 0, 0, 0, 0, 3, 0, 0, 1, 0, 0, 0, 1, 4, 11, 0, 14, 0, 136, 0, 1, 0, 0, 25, 6, 0, 0, 56, 0, 0, 0, 0, 0, 0, 0, 0, 72, 0, 1, 0, 6, 0, 0, 27, 0, 0, 0, 0, 0, 0, 2, 0, 1, 0, 66, 0, 0, 0, 0, 0, 0, 101, 0, 6, 0, 67, 0, 0, 24, 0, 0, 0, 164, 1, 38, 5, 0, 0, 0, 0, 0, 0, 1, 0, 2, 0, 0, 29, 0, 0, 0, 81, 1, 2, 7, 0, 1, 1, 0, 0, 29, 251, 10, 0, 0, 0, 8, 0, 0, 0, 0, 0, 1, 0, 0, 36, 0, 0, 0, 0, 0, 26, 83, 0, 1, 0, 0, 0, 0, 0, 32, 150, 9, 0, 83, 1, 0, 66, 0, 0, 0, 0, 9, 3, 5, 0, 0, 0, 0, 44, 28, 0, 1, 0, 26, 46, 0, 66, 0, 46, 0, 0, 0, 7, 0, 6, 0, 0, 2, 8, 15, 0, 0, 33, 27, 0, 1, 8, 0, 105, 0, 0, 9, 0, 7, 46, 36, 60, 5, 0, 10, 0, 0, 4, 0, 7, 0, 0, 48, 67, 2, 1, 0, 0, 1, 0, 0, 0, 0, 0, 0, 0, 41, 0, 11, 0, 0, 16, 30, 7, 1, 0, 0, 0, 1415, 0, 94, 0, 0, 0, 75, 0, 38, 0, 0, 0, 0, 10, 11, 13, 1, 0, 4, 0, 0, 31, 14, 0, 122, 6, 12, 51, 7, 0, 0, 0, 17, 0, 0, 0, 13, 0, 0, 0, 0, 32, 0, 19, 142, 7, 0, 1, 0, 88, 6, 12, 2, 121, 0, 0, 0, 38, 46, 0, 0, 22, 27, 0, 0, 0, 0, 20, 0, 14, 0, 0, 6, 0, 0, 20, 0, 0, 0, 0, 62, 0, 0, 14, 0, 6, 3, 0, 0, 0, 0, 0, 2, 0, 0, 0, 0, 0, 118, 0, 0, 5, 0, 8, 0, 0, 106, 0, 0, 98, 0, 0, 6, 0, 3, 0, 0, 1, 27, 0, 21, 1, 0, 0, 24, 50, 0, 0, 15, 15, 3, 98, 0, 0, 13, 0, 0, 42, 0, 0, 6, 0, 4, 50, 0, 0, 0, 0, 0, 12, 0, 0, 0, 0, 0, 0, 0, 0, 0, 1, 0, 27, 49, 0, 2, 8, 7, 0, 0, 0, 0, 0, 0, 0, 1, 1272, 0, 10, 1, 0, 99, 0, 0, 32, 0, 0, 0, 0, 109, 0, 81, 10, 0, 35, 0, 1, 162, 0, 0, 0, 0, 0, 0, 7, 6, 4, 35, 0, 86, 84, 0, 0, 0, 538, 0, 0, 53, 0, 25, 0, 0, 0, 0, 0, 0, 0, 0, 0, 0, 0, 0, 37, 0, 0, 0, 0, 0, 0, 20, 0, 1, 0, 0, 0, 0, 0, 0, 0, 14, 0, 13, 6, 102, 5, 0, 15, 0, 0, 0, 0, 0, 0, 0, 0, 0, 2, 55, 78, 0, 12, 1, 0, 0, 0, 8, 0, 0, 86, 0, 5, 3, 3, 6, 0, 0, 0, 0, 0, 3, 15, 0, 1531, 36, 5, 0, 2, 0, 0, 6, 0, 0, 0, 0, 3, 4, 0, 0, 0, 176, 0, 0, 4, 11, 0, 0, 0, 0, 0, 0, 13, 0, 0, 78, 0, 0, 2, 0, 0, 115, 78, 0, 0, 2, 0, 0, 0, 16, 14, 0, 0, 0, 0, 0, 0, 9, 0, 0, 25, 0, 6, 0, 37, 0, 0, 0, 23, 0, 0, 0, 0, 6, 2, 32, 0, 31, 0, 13, 5, 0, 22, 5, 73, 0, 17, 0, 0, 43, 0, 0, 78, 18, 27, 0, 97, 0, 24, 0, 0, 70, 0, 0, 2, 0, 84, 0, 0, 7, 0, 124, 0, 0, 0, 2, 0, 4, 0, 1, 1, 0, 68, 0, 0, 0, 0, 87, 6, 1, 0, 2, 0, 1, 0, 0, 0, 0, 0, 2, 23, 0, 0, 0, 0, 0, 164, 0, 0, 82, 1, 1, 0, 3, 0, 0, 134, 0, 0, 1, 5, 0, 0, 0, 5, 99, 4, 1, 0, 0, 0, 137, 40, 0, 0, 0, 95, 0, 2, 58, 1, 13, 0, 0, 0, 0, 5, 0, 0, 0, 10, 1, 1, 0, 21, 0, 0, 21, 40, 0, 0, 0, 0, 0, 0, 0, 0, 0, 0, 0, 4, 0, 0, 0, 93, 0, 1, 36, 0, 0, 0, 0, 0, 0, 0, 7, 1, 0, 0, 0, 1, 0, 0, 51, 0, 0, 0, 0, 36, 3, 9, 72, 0, 0, 43, 153, 4, 0, 30, 1, 55, 16, 0, 35, 1, 0, 0, 0, 5, 0, 0, 154, 0, 0, 0, 0, 0, 0, 0, 0, 0, 0, 76, 0, 0, 0, 6, 0, 2, 0, 0, 0, 0, 6, 0, 0, 0, 30, 0, 7, 0, 0, 4, 25, 0, 72, 0, 9, 2, 0, 0, 4, 0, 1, 0, 5, 0, 0, 0, 0, 0, 45, 24, 27, 79, 8, 0, 0, 0, 0, 0, 108, 0, 0, 0, 0, 5, 0, 0, 165, 0, 22, 0, 0, 0, 0, 17, 0, 0, 0, 0, 9, 7, 0, 6, 0, 38, 10, 0, 0, 0, 16, 0, 4, 186, 68, 0, 13, 1, 0, 24, 0, 5, 0, 0, 1, 21, 18, 0, 0, 6, 0, 0, 2, 0, 0, 0, 0, 43, 0, 0, 0, 0, 7, 0, 0, 0, 0, 0, 0, 13, 0, 2, 0, 2, 0, 0, 4, 0, 32, 0, 0, 1, 16, 0, 0, 0, 43, 0, 0, 0, 67, 0, 0, 0, 24, 0, 0, 2, 2, 0, 0, 38, 0, 0, 39, 18, 0, 29, 0, 10, 0, 0, 1, 0, 0, 15, 0, 0, 3, 0, 0, 0, 12, 0, 1, 0, 14, 0, 0, 0, 130, 0, 0, 84, 0, 0, 2, 72, 0, 31, 4, 0, 0, 0, 3, 0, 0, 0, 0, 1, 5, 12, 23, 15, 0, 1, 0, 33, 49, 4, 0, 18, 29, 3, 1, 0, 0, 174, 0, 0, 0, 0, 0, 88, 3, 0, 0, 0, 4, 0, 0, 0, 40, 0, 27, 0, 0, 0, 1, 0, 0, 6, 0, 0, 8, 0, 35, 1, 0, 12, 0, 0, 0, 2, 0, 2, 0, 11, 2, 23, 1, 1, 0, 0, 0, 0, 94, 0, 0, 0, 23, 0, 22, 0, 0, 0, 1, 0, 0, 0, 0, 1, 26, 0, 0, 0, 1, 0, 23, 0, 16, 0, 0, 0, 159, 50, 0, 2, 49, 27, 1, 0, 0, 3, 0, 40, 0, 108, 0, 0, 0, 65, 18, 0, 0, 0, 0, 0, 2, 1, 60, 0, 0, 0, 0, 1, 75, 2, 69, 1, 136, 19, 0, 0, 0, 99, 0, 11, 7, 30, 0, 0, 4, 0, 0, 0, 2, 34, 0, 0, 2, 2, 8, 0, 0, 2, 0, 0, 0, 0, 0, 1, 0, 1, 0, 0, 7, 13, 0, 1, 0, 0, 0, 0, 1, 142, 0, 16, 1, 0, 34, 0, 0, 0, 0, 1, 1, 24, 0, 0, 7, 0, 0, 0, 8, 1, 0, 27, 0, 16, 12, 74, 0, 0, 0, 0, 0, 0, 0, 0, 0, 0, 0, 0, 0, 65, 25, 0, 82, 7, 14, 1, 2, 0, 0, 65, 19, 41, 0, 29, 3, 0, 0, 0, 28, 1, 0, 0, 51, 3, 0, 0, 7, 0, 0, 0, 0, 0, 6, 0, 0, 0, 13, 2, 0, 31, 312, 0, 0, 0, 0, 0, 6, 0, 126, 0, 0, 0, 13, 12, 1, 0, 0, 0, 2, 0, 3, 0, 0, 0, 10, 38, 0, 0, 0, 13, 0, 0, 6, 0, 0, 0, 1207, 27, 0, 0, 37, 0, 0, 0, 0, 4, 2, 0, 0, 0, 18, 0, 0, 105, 3, 0, 1, 2, 3, 0, 35, 0, 32, 1, 0, 0, 0, 0, 0, 0, 25, 1, 0, 5, 32, 4, 14, 95, 3, 0, 0, 0, 0, 0, 0, 1, 0, 1, 117, 0, 0, 0, 0, 0, 0, 0, 0, 1, 0, 29, 0, 0, 145, 103, 44, 80, 1, 0, 54, 1, 0, 0, 41, 45, 0, 0, 0, 4, 0, 0, 0, 0, 0, 8, 0, 24, 0, 22, 11, 0, 0, 19, 0, 0, 0, 6, 0, 17, 0, 65, 0, 17, 0, 0, 0, 4, 80, 0, 0, 0, 0, 0, 0, 0, 0, 8, 7, 0, 0, 6, 0, 1, 39, 9, 17, 23, 0, 0, 6, 23, 0, 82, 0, 0, 0, 0, 0, 0, 0, 14, 0, 0, 0, 0, 15, 1, 0, 0, 45, 28, 19, 0, 0, 2, 0, 85, 0, 0, 0, 0, 5, 0, 0, 0, 0, 3, 4, 0, 4, 45, 0, 0, 0, 25, 5, 16, 0, 2, 6, 7, 5, 0, 0, 5, 0, 0, 3, 0, 38, 5, 18, 0, 2, 0, 1, 0, 428, 32, 1, 0, 0, 0, 0, 0, 1, 0, 0, 1, 0, 1, 91, 0, 0, 0, 40, 0, 0, 735, 0, 0, 11, 0, 4, 0, 1, 0, 0, 0, 0, 0, 0, 0, 0, 38, 0, 0, 0, 2, 0, 0, 0, 0, 0, 0, 20, 0, 0, 0, 0, 19, 0, 0, 0, 0, 1, 1, 3, 0, 245, 0, 0, 0, 14, 11, 0, 0, 0, 3, 99, 8, 2, 1, 0, 14, 21, 2, 0, 79, 2, 0, 1, 40, 61, 125, 0, 0, 1, 2, 1, 0, 4, 0, 0, 9, 2, 0, 0, 0, 0, 0, 0, 1, 11, 0, 24, 0, 0, 0, 16, 2, 11, 0, 6, 0, 31, 1, 0, 0, 1, 3, 54, 0, 0, 60, 64, 0, 1, 0, 0, 0, 2, 0, 10, 1, 0, 0, 0, 3, 0, 9, 31, 0, 22, 36, 0, 0, 1, 10, 3, 0, 126, 0, 13, 0, 0, 0, 0, 0, 0, 55, 0, 37, 41, 3, 0, 0, 0, 1, 2, 0, 0, 0, 0, 1, 0, 0, 0, 26, 1, 36, 0, 0, 0, 22, 0, 0, 0, 4, 31, 42, 1, 0, 25, 0, 0, 21, 1, 0, 2, 0, 128, 99, 0, 2, 0, 7, 2, 0, 1, 9, 0, 1, 0, 0, 1, 2, 15, 0, 25, 0, 0, 3, 0, 0, 0, 0, 21, 0, 0, 0, 52, 0, 0, 0, 0, 65, 0, 33, 0, 1, 0, 0, 1, 0, 0, 2, 0, 45, 59, 83, 2
Bill-Gates-A-Biography-_Becraft_-Michael_-_z-lib.org_, 0, 0, 0, 70, 23, 0, 0, 0, 0, 49, 3, 35, 0, 0, 0, 0, 1, 0, 0, 0, 0, 0, 0, 11, 0, 0, 0, 0, 0, 2, 0, 0, 0, 0, 0, 1, 0, 2, 46, 0, 7, 0, 5, 0, 0, 0, 0, 1, 1, 0, 0, 18, 0, 0, 0, 0, 0, 0, 0, 0, 33, 0, 0, 0, 0, 0, 0, 40, 0, 0, 0, 0, 0, 0, 1, 0, 0, 0, 3, 0, 0, 0, 0, 0, 0, 15, 0, 0, 0, 75, 0, 0, 49, 0, 0, 0, 3, 0, 1, 1, 0, 0, 27, 0, 0, 0, 68, 0, 0, 0, 0, 16, 0, 0, 0, 1, 0, 0, 1, 0, 0, 0, 0, 0, 1, 84, 0, 0, 0, 0, 49, 0, 8, 0, 0, 0, 0, 0, 0, 0, 0, 0, 0, 0, 22, 4, 11, 0, 0, 0, 0, 3, 0, 0, 9, 3, 2, 0, 14, 0, 30, 8, 0, 0, 26, 0, 9, 3, 11, 0, 0, 0, 0, 32, 0, 0, 0, 0, 7, 17, 0, 10, 0, 11, 0, 0, 0, 2, 0, 4, 0, 0, 0, 0, 3, 0, 0, 55, 8, 0, 0, 0, 0, 60, 0, 0, 0, 0, 0, 0, 59, 14, 10, 0, 12, 0, 1, 0, 0, 1, 0, 0, 0, 0, 54, 0, 0, 0, 0, 0, 0, 0, 0, 0, 0, 0, 10, 0, 19, 0, 0, 0, 0, 4, 0, 0, 0, 0, 0, 0, 25, 0, 0, 0, 25, 0, 6, 0, 0, 0, 0, 0, 2, 0, 0, 0, 0, 0, 0, 1, 40, 0, 33, 0, 7, 1, 30, 0, 0, 0, 0, 0, 0, 0, 121, 3, 0, 0, 42, 12, 0, 17, 1, 0, 0, 0, 0, 34, 0, 18, 0, 72, 0, 0, 0, 25, 32, 0, 0, 21, 43, 0, 1, 0, 1, 133, 0, 3, 0, 0, 17, 0, 0, 7, 0, 0, 0, 0, 55, 0, 0, 3, 0, 2, 1, 0, 0, 0, 0, 0, 0, 0, 0, 0, 0, 0, 25, 0, 0, 0, 0, 0, 5, 0, 9, 0, 0, 28, 0, 0, 11, 0, 3, 0, 0, 0, 8, 0, 2, 0, 0, 0, 38, 11, 0, 0, 11, 2, 0, 16, 1, 0, 3, 12, 0, 7, 0, 0, 1, 0, 0, 2, 0, 0, 0, 0, 0, 0, 1, 0, 0, 0, 0, 5, 0, 0, 0, 0, 0, 5, 24, 0, 0, 7, 0, 0, 0, 0, 65, 0, 0, 0, 0, 0, 0, 1, 9, 0, 43, 0, 0, 62, 0, 0, 2, 0, 2, 0, 54, 0, 0, 12, 0, 1, 63, 0, 0, 0, 0, 0, 0, 0, 0, 0, 7, 2, 20, 4, 2, 0, 0, 194, 2, 0, 5, 0, 12, 0, 0, 0, 0, 0, 0, 0, 1, 0, 1, 0, 0, 9, 1, 0, 0, 0, 0, 0, 6, 0, 7, 0, 0, 0, 0, 0, 0, 0, 14, 0, 3, 6, 0, 0, 0, 2, 0, 0, 0, 0, 0, 0, 0, 0, 0, 0, 10, 42, 0, 0, 0, 0, 0, 0, 12, 0, 0, 7, 0, 2, 0, 1, 1, 0, 0, 0, 0, 2, 3, 7, 0, 1, 1, 0, 0, 0, 0, 0, 0, 0, 0, 0, 0, 1, 1, 0, 0, 0, 8, 0, 0, 1, 151, 0, 0, 0, 0, 0, 0, 1, 0, 0, 35, 0, 0, 4, 0, 0, 1, 19, 0, 1, 3, 0, 0, 0, 8, 0, 0, 0, 0, 0, 0, 0, 6, 0, 0, 11, 0, 2, 0, 15, 0, 0, 0, 19, 0, 0, 0, 0, 0, 0, 1, 0, 2, 2, 2, 0, 0, 26, 0, 0, 0, 6, 0, 0, 9, 0, 0, 15, 3, 1, 0, 19, 0, 1, 0, 0, 19, 0, 0, 0, 0, 5, 0, 0, 0, 0, 19, 0, 0, 0, 0, 0, 12, 0, 15, 1, 0, 138, 0, 0, 0, 0, 27, 15, 44, 0, 0, 0, 0, 0, 0, 0, 0, 0, 2, 46, 0, 0, 0, 0, 0, 95, 0, 0, 23, 0, 0, 0, 0, 0, 0, 20, 0, 0, 2, 4, 0, 0, 0, 0, 16, 0, 0, 0, 0, 0, 19, 6, 0, 0, 0, 9, 0, 4, 16, 0, 6, 0, 0, 0, 0, 0, 0, 0, 0, 3, 0, 2, 0, 0, 0, 0, 18, 0, 0, 0, 0, 0, 0, 0, 0, 0, 0, 0, 0, 4, 0, 0, 0, 94, 0, 0, 11, 0, 0, 0, 0, 33, 0, 0, 5, 0, 0, 0, 0, 0, 0, 0, 12, 0, 0, 0, 0, 11, 0, 1, 18, 0, 0, 84, 7, 0, 0, 1, 0, 19, 2, 0, 18, 14, 0, 0, 0, 38, 0, 0, 42, 0, 41, 0, 0, 0, 0, 0, 0, 0, 0, 12, 0, 1, 0, 7, 0, 0, 0, 0, 0, 0, 13, 0, 0, 0, 3, 0, 0, 0, 0, 5, 2, 0, 23, 0, 0, 0, 0, 0, 0, 0, 1, 0, 0, 0, 0, 0, 0, 0, 146, 1, 27, 27, 7, 29, 2, 6, 0, 0, 34, 0, 0, 0, 0, 5, 0, 0, 0, 0, 0, 0, 0, 0, 0, 5, 0, 0, 0, 0, 1, 0, 1, 0, 1, 12, 2, 0, 0, 0, 817, 0, 0, 96, 44, 0, 0, 0, 0, 5, 0, 3, 0, 0, 0, 7, 16, 0, 12, 1, 0, 0, 0, 0, 0, 0, 0, 48, 0, 0, 0, 0, 2, 0, 0, 0, 0, 0, 0, 0, 0, 0, 0, 0, 0, 0, 0, 0, 6, 0, 0, 1, 0, 11, 0, 0, 14, 0, 0, 0, 0, 0, 0, 0, 0, 0, 0, 2, 2, 0, 0, 19, 0, 0, 2, 0, 0, 1, 0, 6, 0, 0, 0, 0, 0, 3, 0, 0, 0, 0, 0, 0, 1, 0, 1, 0, 27, 0, 4, 1, 70, 0, 0, 4, 0, 0, 0, 73, 0, 42, 0, 0, 0, 0, 0, 0, 0, 0, 1, 0, 4, 3, 7, 7, 0, 0, 0, 7, 2, 0, 0, 12, 4, 0, 0, 0, 0, 55, 0, 0, 0, 0, 0, 29, 5, 2, 0, 1, 0, 0, 0, 0, 4, 0, 49, 0, 0, 0, 0, 0, 0, 2, 0, 0, 0, 0, 18, 1, 0, 1, 0, 0, 0, 1, 0, 1, 0, 1, 0, 11, 0, 0, 0, 0, 0, 0, 11, 0, 0, 0, 14, 0, 3, 0, 0, 0, 2, 0, 0, 0, 0, 0, 10, 0, 0, 0, 0, 0, 14, 0, 68, 0, 0, 0, 64, 10, 0, 0, 10, 11, 0, 0, 0, 5, 0, 12, 0, 14, 6, 0, 0, 4, 32, 1, 0, 0, 0, 0, 0, 0, 29, 0, 0, 2, 0, 0, 15, 0, 24, 0, 24, 69, 0, 0, 0, 7, 0, 8, 5, 4, 0, 0, 0, 0, 0, 0, 1, 37, 0, 0, 2, 0, 13, 0, 0, 2, 0, 3, 0, 0, 0, 0, 0, 1, 0, 0, 4, 7, 1, 0, 0, 0, 0, 0, 0, 8, 0, 0, 0, 0, 0, 0, 0, 0, 0, 0, 2, 48, 1, 0, 2, 0, 0, 0, 7, 1, 0, 7, 0, 0, 5, 10, 0, 0, 0, 0, 0, 0, 0, 0, 0, 0, 0, 0, 0, 25, 0, 0, 17, 2, 1, 2, 0, 0, 0, 0, 0, 38, 0, 1, 0, 0, 0, 0, 12, 1, 0, 0, 3, 0, 0, 0, 0, 0, 0, 0, 0, 0, 3, 0, 0, 0, 1, 0, 34, 10, 134, 0, 1, 30, 0, 0, 0, 0, 11, 0, 0, 0, 58, 12, 0, 0, 0, 0, 0, 0, 0, 0, 0, 0, 0, 2, 0, 0, 0, 0, 0, 0, 6, 0, 0, 0, 244, 22, 0, 0, 9, 0, 0, 0, 0, 0, 2, 3, 9, 0, 1, 0, 0, 10, 2, 0, 0, 45, 0, 0, 4, 0, 8, 0, 0, 0, 0, 1, 0, 0, 19, 0, 0, 0, 26, 0, 4, 57, 1, 0, 0, 0, 0, 0, 0, 0, 0, 108, 7, 0, 0, 0, 0, 0, 0, 0, 0, 0, 0, 5, 0, 0, 4, 16, 11, 10, 0, 1, 3, 83, 0, 0, 11, 13, 0, 0, 0, 1, 0, 0, 0, 0, 6, 2, 0, 0, 0, 8, 0, 0, 0, 13, 0, 0, 0, 1, 0, 1, 0, 37, 0, 9, 0, 0, 0, 1, 60, 0, 0, 0, 0, 0, 0, 0, 0, 0, 25, 0, 0, 12, 0, 0, 6, 5, 19, 16, 0, 0, 3, 6, 0, 12, 0, 1, 0, 0, 0, 0, 0, 5, 0, 0, 0, 0, 11, 0, 0, 0, 6, 0, 10, 0, 0, 48, 0, 31, 0, 0, 0, 0, 0, 0, 0, 0, 0, 2, 5, 0, 1, 0, 0, 0, 0, 21, 2, 4, 0, 0, 6, 0, 2, 0, 0, 7, 0, 0, 0, 0, 5, 0, 7, 0, 0, 0, 0, 0, 101, 41, 0, 0, 0, 0, 0, 0, 1, 0, 0, 0, 0, 0, 4, 0, 0, 0, 0, 0, 0, 1, 0, 0, 0, 0, 1, 0, 11, 0, 0, 0, 1, 0, 0, 0, 0, 10, 0, 0, 0, 0, 0, 0, 0, 0, 0, 0, 9, 0, 0, 0, 1, 18, 0, 0, 0, 0, 1, 0, 2, 0, 2, 0, 0, 0, 0, 1, 0, 0, 0, 2, 0, 1, 0, 1, 0, 0, 23, 5, 0, 30, 6, 0, 0, 24, 25, 15, 14, 0, 0, 0, 0, 0, 0, 2, 0, 28, 6, 0, 0, 0, 0, 0, 0, 0, 10, 0, 206, 0, 0, 0, 38, 0, 37, 0, 0, 0, 10, 0, 0, 14, 0, 1, 19, 1, 0, 53, 13, 0, 0, 0, 0, 0, 0, 0, 1, 0, 0, 0, 0, 0, 0, 0, 0, 0, 15, 36, 0, 0, 0, 3, 0, 0, 20, 0, 11, 0, 0, 0, 0, 0, 0, 27, 0, 4, 11, 1, 0, 0, 0, 0, 1, 0, 1, 0, 0, 0, 0, 0, 0, 3, 0, 10, 0, 0, 0, 6, 0, 0, 0, 21, 50, 43, 0, 0, 33, 0, 0, 22, 0, 0, 0, 0, 41, 46, 0, 0, 0, 3, 1, 0, 2, 0, 0, 0, 0, 0, 0, 1, 12, 0, 7, 0, 0, 2, 13, 0, 0, 1, 4, 0, 0, 4, 14, 0, 0, 0, 2, 25, 0, 12, 0, 0, 0, 0, 0, 0, 0, 1, 0, 5, 6, 4, 0
Bitter-Brew-The-Rise-and-Fall-of-Anheuser-Busch-and-Americas-Kings-of-Beer-by-William-Knoedelseder-_, 0, 0, 0, 34, 76, 0, 0, 0, 0, 22, 0, 16, 1, 0, 0, 0, 0, 0, 0, 0, 0, 0, 0, 12, 0, 0, 0, 0, 4, 0, 0, 0, 0, 0, 0, 0, 0, 0, 28, 0, 3, 0, 36, 0, 0, 0, 0, 9, 0, 0, 0, 48, 0, 0, 0, 0, 0, 0, 0, 0, 68, 0, 0, 0, 2, 0, 0, 26, 0, 5, 0, 0, 2, 0, 0, 1, 0, 0, 24, 0, 0, 0, 0, 0, 0, 31, 0, 0, 0, 83, 2, 0, 9, 0, 0, 0, 0, 0, 1, 10, 1, 0, 0, 0, 0, 0, 0, 0, 11, 0, 0, 19, 196, 0, 0, 28, 0, 6, 4, 0, 0, 0, 0, 0, 26, 200, 0, 0, 0, 0, 3, 0, 0, 0, 0, 0, 1, 0, 11, 7, 0, 0, 0, 0, 1, 12, 46, 0, 0, 0, 0, 0, 12, 0, 9, 24, 5, 0, 28, 7, 0, 19, 0, 0, 1, 0, 76, 2, 11, 3, 0, 1, 0, 11, 3, 0, 0, 0, 40, 20, 0, 55, 0, 38, 0, 0, 0, 19, 0, 8, 0, 0, 1, 5, 10, 0, 0, 1, 5, 0, 0, 21, 0, 36, 0, 0, 4, 0, 10, 1, 15, 19, 3, 0, 7, 0, 0, 1, 0, 12, 0, 0, 0, 0, 19, 0, 0, 0, 2, 0, 0, 1, 0, 0, 0, 0, 21, 0, 0, 0, 0, 6, 4, 0, 1, 0, 0, 0, 0, 0, 23, 0, 0, 0, 55, 0, 18, 0, 0, 0, 0, 9, 11, 2, 0, 0, 0, 0, 0, 16, 5, 0, 19, 1, 35, 52, 2, 0, 0, 0, 34, 0, 0, 0, 20, 0, 0, 0, 4, 11, 0, 20, 2, 0, 0, 14, 0, 17, 2, 20, 0, 1, 0, 0, 0, 47, 26, 0, 0, 0, 24, 0, 0, 0, 1, 14, 0, 15, 0, 0, 8, 0, 0, 7, 0, 0, 0, 0, 14, 0, 0, 8, 0, 9, 8, 0, 0, 2, 0, 0, 0, 0, 0, 0, 0, 0, 12, 1, 0, 3, 0, 7, 3, 0, 39, 0, 0, 101, 0, 0, 11, 0, 6, 36, 0, 0, 9, 0, 6, 2, 0, 1, 0, 4, 0, 0, 9, 75, 0, 96, 0, 0, 10, 0, 0, 7, 1, 0, 273, 0, 8, 1, 0, 0, 0, 0, 0, 0, 0, 0, 0, 0, 0, 0, 0, 0, 0, 0, 0, 36, 0, 0, 0, 0, 12, 0, 0, 0, 0, 0, 0, 0, 5, 0, 0, 22, 0, 0, 38, 0, 0, 6, 0, 2, 0, 0, 0, 0, 42, 18, 0, 25, 0, 1, 80, 165, 0, 0, 0, 0, 0, 1, 8, 1, 42, 0, 49, 5, 0, 0, 0, 271, 0, 3, 12, 0, 27, 0, 22, 0, 0, 0, 0, 0, 0, 0, 0, 0, 0, 46, 0, 0, 0, 0, 0, 0, 18, 0, 0, 0, 0, 0, 0, 0, 0, 0, 4, 2, 17, 12, 0, 1, 0, 15, 0, 0, 56, 0, 0, 0, 0, 1, 0, 0, 25, 57, 0, 5, 0, 0, 0, 0, 44, 2, 0, 33, 28, 0, 0, 3, 20, 0, 0, 0, 0, 0, 1, 19, 0, 0, 32, 1, 0, 49, 0, 0, 1, 0, 0, 0, 0, 0, 7, 0, 0, 0, 36, 0, 0, 3, 3, 0, 0, 0, 0, 0, 0, 12, 0, 0, 29, 0, 0, 5, 0, 0, 1, 44, 0, 2, 1, 0, 0, 0, 10, 3, 0, 0, 0, 44, 0, 0, 49, 0, 0, 1, 0, 15, 0, 96, 0, 0, 0, 28, 0, 0, 0, 0, 3, 14, 54, 5, 42, 0, 22, 0, 0, 5, 3, 0, 0, 0, 0, 0, 80, 0, 0, 9, 6, 29, 0, 37, 7, 41, 0, 0, 43, 0, 0, 22, 0, 25, 0, 0, 33, 0, 33, 0, 0, 0, 0, 0, 18, 0, 2, 7, 0, 15, 0, 0, 0, 0, 42, 0, 0, 0, 2, 0, 1, 0, 65, 0, 0, 0, 0, 19, 0, 0, 0, 59, 0, 70, 0, 0, 14, 1, 0, 0, 6, 1, 0, 9, 0, 0, 1, 1, 0, 0, 0, 0, 22, 2, 0, 0, 0, 0, 143, 6, 0, 0, 0, 112, 0, 0, 32, 0, 8, 0, 0, 0, 0, 4, 0, 0, 0, 25, 0, 4, 0, 10, 0, 0, 26, 88, 0, 0, 0, 0, 0, 0, 0, 0, 0, 0, 0, 12, 6, 0, 0, 21, 22, 1, 5, 0, 0, 0, 1, 0, 38, 0, 13, 0, 0, 0, 1, 0, 0, 0, 12, 0, 0, 0, 0, 23, 0, 1, 7, 0, 0, 1, 2, 4, 0, 6, 3, 18, 1, 0, 18, 3, 0, 1, 0, 5, 0, 7, 66, 0, 0, 0, 0, 0, 0, 0, 0, 0, 0, 29, 23, 0, 0, 3, 0, 75, 0, 0, 0, 0, 17, 0, 0, 0, 39, 0, 3, 0, 0, 5, 7, 0, 18, 0, 14, 4, 0, 0, 7, 2, 0, 0, 0, 0, 0, 0, 1, 1, 6, 8, 16, 13, 29, 0, 3, 0, 0, 0, 13, 0, 0, 0, 0, 3, 0, 0, 0, 0, 1, 0, 0, 0, 0, 14, 1, 5, 0, 0, 47, 12, 1, 5, 1, 12, 15, 0, 0, 0, 15, 0, 3, 107, 15, 0, 13, 0, 0, 26, 0, 13, 0, 38, 0, 9, 2, 3, 0, 3, 0, 0, 0, 0, 0, 0, 0, 8, 0, 0, 0, 0, 17, 0, 0, 0, 0, 0, 1, 2, 0, 0, 0, 2, 0, 1, 5, 2, 39, 0, 0, 4, 0, 5, 0, 87, 12, 0, 0, 0, 0, 0, 0, 0, 6, 0, 0, 0, 1, 0, 0, 24, 3, 0, 67, 2, 0, 12, 0, 16, 0, 1, 0, 0, 0, 8, 0, 0, 10, 0, 0, 0, 6, 0, 0, 0, 14, 0, 0, 0, 23, 0, 0, 52, 0, 0, 3, 89, 0, 9, 9, 0, 0, 0, 1, 0, 0, 0, 1, 1, 0, 21, 8, 1, 0, 0, 0, 1, 7, 4, 0, 39, 3, 0, 9, 0, 0, 183, 0, 0, 0, 1, 0, 22, 9, 1, 0, 0, 28, 0, 0, 0, 4, 0, 32, 0, 0, 0, 1, 0, 0, 0, 0, 0, 1, 0, 32, 0, 0, 3, 0, 0, 0, 5, 0, 2, 0, 0, 0, 50, 2, 0, 0, 0, 0, 0, 17, 3, 0, 0, 34, 0, 95, 0, 0, 0, 3, 0, 0, 0, 0, 0, 32, 0, 0, 2, 0, 0, 27, 0, 4, 0, 2, 3, 64, 77, 0, 79, 30, 29, 2, 0, 0, 1, 0, 9, 0, 90, 0, 0, 0, 12, 30, 0, 0, 0, 0, 0, 1, 1, 45, 25, 0, 14, 0, 6, 15, 0, 9, 0, 133, 4, 0, 0, 0, 0, 0, 40, 2, 4, 0, 0, 0, 0, 0, 0, 7, 55, 0, 2, 2, 1, 742, 0, 0, 2, 0, 0, 0, 0, 0, 0, 0, 1, 0, 1, 10, 7, 0, 0, 0, 0, 0, 0, 1, 58, 0, 6, 1, 0, 0, 0, 0, 0, 0, 3, 0, 6, 0, 0, 8, 3, 0, 0, 7, 0, 0, 19, 3, 3, 80, 51, 1, 0, 0, 0, 0, 0, 0, 0, 0, 0, 0, 0, 1, 39, 16, 0, 47, 1, 7, 1, 0, 0, 0, 0, 366, 24, 0, 21, 51, 0, 0, 0, 5, 2, 0, 0, 24, 4, 0, 0, 1, 23, 0, 0, 0, 0, 10, 0, 0, 0, 3, 7, 0, 11, 76, 0, 0, 0, 0, 0, 0, 0, 58, 0, 0, 0, 7, 20, 0, 0, 0, 0, 1, 0, 0, 2, 0, 0, 9, 0, 0, 0, 4, 0, 0, 0, 37, 4, 0, 0, 427, 1, 0, 0, 25, 0, 0, 0, 2, 2, 0, 2, 1, 0, 9, 0, 0, 116, 0, 0, 0, 0, 3, 0, 0, 0, 62, 0, 0, 0, 0, 1, 0, 0, 76, 0, 0, 0, 20, 6, 30, 38, 10, 0, 0, 0, 0, 0, 0, 0, 0, 0, 0, 1, 0, 1, 0, 0, 0, 0, 0, 0, 0, 9, 0, 140, 0, 69, 45, 22, 0, 1, 20, 7, 0, 80, 15, 4, 1, 0, 0, 4, 0, 0, 0, 0, 0, 8, 0, 9, 0, 3, 0, 0, 2, 27, 0, 0, 0, 38, 0, 12, 0, 218, 0, 11, 0, 2, 0, 15, 94, 0, 0, 0, 0, 0, 0, 1, 0, 42, 11, 0, 0, 14, 0, 0, 18, 8, 4, 31, 0, 0, 11, 10, 0, 66, 0, 1, 0, 0, 0, 14, 0, 1, 2, 0, 0, 0, 6, 3, 0, 0, 21, 3, 41, 0, 0, 27, 0, 28, 1, 0, 0, 2, 2, 0, 0, 0, 0, 0, 0, 0, 26, 0, 0, 0, 0, 7, 0, 7, 493, 1, 7, 13, 21, 0, 0, 4, 0, 0, 0, 0, 52, 2, 17, 0, 0, 0, 1, 0, 128, 24, 0, 0, 0, 0, 0, 0, 1, 0, 0, 0, 0, 0, 3, 0, 0, 0, 11, 0, 0, 1, 0, 0, 3, 0, 0, 0, 17, 0, 0, 0, 2, 0, 0, 0, 0, 15, 0, 0, 0, 99, 0, 0, 0, 0, 0, 0, 25, 0, 0, 0, 103, 6, 0, 0, 0, 0, 1, 0, 3, 0, 3, 0, 0, 0, 1, 12, 0, 0, 0, 0, 0, 10, 0, 0, 2, 8, 10, 0, 0, 97, 0, 0, 1, 17, 8, 29, 0, 18, 4, 3, 0, 0, 2, 0, 0, 8, 62, 0, 0, 0, 0, 0, 0, 0, 11, 0, 0, 0, 0, 0, 19, 0, 0, 0, 2, 0, 10, 0, 0, 13, 209, 0, 45, 0, 0, 49, 40, 0, 0, 0, 0, 0, 1, 0, 14, 0, 0, 0, 0, 0, 0, 0, 0, 0, 21, 27, 17, 0, 0, 33, 0, 0, 44, 0, 25, 0, 0, 0, 0, 0, 0, 17, 0, 32, 66, 0, 0, 0, 431, 108, 0, 0, 3, 5, 0, 0, 4, 0, 21, 23, 1, 18, 0, 0, 0, 1, 0, 0, 0, 0, 1, 78, 0, 0, 11, 0, 0, 36, 0, 0, 0, 0, 6, 37, 0, 1, 0, 4, 11, 0, 32, 5, 0, 1, 0, 0, 7, 0, 60, 0, 15, 0, 0, 1, 0, 30, 0, 0, 11, 0, 0, 1, 75, 0, 0, 0, 0, 113, 0, 12, 0, 0, 0, 0, 0, 0, 0, 0, 167, 38, 57, 13, 1
Buffett-The-Making-of-an-American-Capitalist-_Roger-Lowenstein_-_z-lib.org_, 0, 0, 0, 98, 38, 0, 0, 0, 0, 92, 0, 103, 5, 0, 0, 0, 4, 0, 0, 0, 0, 0, 0, 16, 0, 0, 0, 1, 0, 1, 0, 0, 1, 0, 0, 0, 0, 0, 49, 0, 93, 0, 63, 0, 0, 0, 0, 11, 0, 0, 0, 42, 0, 0, 0, 1, 0, 0, 0, 0, 111, 2, 0, 2, 30, 0, 0, 18, 3, 6, 0, 0, 0, 0, 13, 0, 0, 0, 47, 0, 0, 0, 0, 0, 0, 74, 0, 3, 0, 238, 1, 0, 9, 2, 1, 0, 3, 0, 5, 2, 49, 0, 0, 0, 0, 0, 2, 0, 132, 0, 0, 7, 0, 0, 0, 16, 0, 7, 4, 0, 1, 0, 1, 0, 3, 207, 0, 0, 0, 0, 32, 0, 0, 0, 0, 0, 1, 0, 0, 1, 0, 0, 0, 0, 0, 1, 44, 0, 0, 0, 0, 0, 3, 0, 12, 10, 4, 1, 55, 25, 0, 71, 0, 0, 2, 0, 6, 1, 36, 2, 0, 16, 0, 26, 0, 0, 2, 0, 29, 64, 0, 29, 0, 40, 0, 0, 0, 20, 0, 21, 0, 1, 3, 2, 35, 2, 2, 10, 14, 0, 0, 3, 0, 54, 0, 0, 7, 0, 18, 7, 14, 7, 9, 0, 19, 0, 280, 0, 0, 24, 0, 0, 0, 0, 5, 0, 0, 0, 10, 0, 4, 1, 0, 0, 0, 0, 6, 0, 0, 0, 0, 10, 6, 0, 2, 0, 0, 0, 0, 9, 47, 0, 0, 0, 646, 0, 25, 0, 0, 0, 0, 12, 23, 22, 2, 0, 3, 8, 0, 12, 2, 0, 33, 4, 89, 36, 11, 0, 2, 0, 36, 0, 0, 0, 10, 0, 0, 0, 1, 14, 0, 11, 8, 1, 26, 12, 0, 26, 2, 23, 3, 9, 0, 0, 0, 50, 27, 0, 0, 0, 19, 0, 0, 0, 0, 14, 0, 3, 0, 1, 8, 0, 0, 13, 0, 0, 0, 0, 62, 0, 0, 9, 0, 6, 1, 0, 0, 0, 0, 0, 4, 0, 0, 0, 0, 0, 33, 3, 0, 5, 0, 13, 1, 0, 130, 1, 0, 79, 0, 0, 4, 0, 10, 1, 0, 0, 21, 0, 14, 9, 0, 0, 3, 72, 0, 0, 23, 16, 0, 54, 98, 0, 15, 0, 0, 3, 0, 0, 9, 0, 64, 2, 0, 0, 0, 0, 0, 0, 1, 0, 0, 0, 167, 0, 0, 0, 0, 0, 0, 96, 1, 0, 0, 0, 1, 0, 0, 0, 0, 0, 0, 0, 3, 0, 0, 9, 0, 0, 73, 0, 0, 1, 0, 1, 0, 0, 0, 1, 88, 1, 19, 11, 0, 11, 114, 0, 1, 0, 0, 0, 0, 4, 11, 0, 52, 0, 61, 14, 0, 0, 0, 409, 0, 7, 6, 0, 27, 0, 0, 0, 0, 0, 0, 0, 0, 0, 0, 0, 0, 38, 0, 0, 4, 0, 1, 0, 7, 0, 2, 0, 0, 0, 0, 0, 0, 0, 2, 1, 21, 23, 0, 1, 0, 29, 0, 0, 0, 0, 0, 0, 0, 5, 0, 0, 21, 141, 0, 3, 0, 0, 7, 0, 122, 0, 2, 20, 0, 5, 0, 1, 15, 0, 0, 1, 0, 0, 1, 23, 0, 0, 35, 7, 0, 4, 10, 0, 7, 0, 0, 1, 0, 0, 6, 0, 0, 0, 72, 0, 0, 25, 1, 0, 0, 0, 0, 0, 0, 29, 0, 0, 46, 0, 0, 10, 0, 0, 19, 71, 26, 42, 3, 0, 0, 0, 19, 8, 0, 0, 0, 0, 0, 0, 5, 0, 0, 8, 0, 11, 0, 84, 0, 0, 0, 86, 0, 0, 0, 0, 7, 9, 36, 78, 273, 0, 1, 1, 0, 5, 13, 0, 0, 1, 0, 0, 101, 0, 0, 28, 1, 8, 0, 20, 4, 10, 0, 0, 253, 0, 0, 3, 0, 55, 0, 0, 30, 0, 43, 1, 0, 0, 0, 1, 51, 0, 1, 2, 0, 92, 0, 0, 0, 4, 9, 0, 0, 0, 6, 0, 7, 0, 0, 0, 50, 0, 0, 33, 4, 0, 0, 0, 2, 71, 0, 0, 20, 1, 0, 18, 17, 1, 0, 8, 0, 0, 1, 3, 0, 0, 0, 2, 47, 27, 0, 0, 0, 0, 16, 44, 0, 0, 0, 55, 0, 0, 22, 0, 64, 0, 0, 0, 0, 10, 0, 0, 0, 33, 0, 10, 0, 10, 0, 0, 32, 37, 0, 1, 0, 0, 0, 0, 0, 0, 0, 0, 0, 8, 7, 0, 3, 15, 0, 2, 172, 0, 0, 0, 3, 2767, 0, 0, 19, 0, 0, 0, 1, 0, 0, 0, 63, 0, 0, 0, 0, 136, 2, 4, 6, 0, 0, 28, 5, 2, 0, 18, 10, 20, 9, 0, 36, 10, 0, 0, 0, 7, 2, 0, 36, 0, 0, 0, 0, 0, 0, 0, 0, 0, 0, 16, 0, 0, 0, 12, 0, 4, 0, 0, 0, 0, 5, 0, 0, 0, 51, 0, 5, 0, 0, 5, 10, 0, 132, 0, 6, 44, 0, 6, 4, 0, 0, 1, 0, 0, 0, 0, 7, 0, 3, 10, 37, 21, 12, 0, 3, 0, 0, 0, 25, 0, 0, 0, 0, 68, 0, 0, 0, 1, 7, 0, 3, 0, 0, 12, 5, 43, 0, 0, 16, 19, 0, 10, 57, 13, 9, 0, 0, 1, 13, 0, 0, 233, 26, 0, 0, 10, 0, 54, 0, 70, 1, 0, 4, 65, 11, 0, 67, 10, 0, 0, 0, 0, 0, 0, 0, 56, 0, 0, 0, 0, 10, 0, 0, 0, 0, 0, 0, 21, 0, 0, 0, 3, 0, 0, 8, 6, 30, 0, 0, 5, 3, 0, 0, 1, 30, 0, 0, 0, 0, 0, 0, 0, 20, 0, 0, 0, 2, 0, 0, 44, 0, 0, 21, 0, 0, 11, 0, 81, 0, 1, 0, 0, 0, 2, 0, 0, 4, 5, 0, 0, 137, 0, 0, 0, 6, 0, 8, 0, 16, 0, 0, 73, 0, 0, 2, 243, 0, 2, 4, 0, 0, 0, 3, 0, 1, 0, 1, 0, 1, 42, 22, 2, 0, 0, 0, 5, 9, 6, 0, 11, 2, 1, 2, 1, 0, 121, 0, 2, 0, 0, 0, 48, 15, 0, 0, 0, 9, 0, 0, 0, 1, 0, 35, 0, 0, 0, 5, 0, 0, 0, 0, 0, 9, 0, 18, 1, 0, 41, 0, 0, 0, 68, 0, 8, 0, 1, 3, 15, 3, 0, 0, 0, 0, 0, 42, 1, 0, 0, 17, 0, 28, 0, 0, 0, 7, 4, 0, 0, 0, 2, 48, 0, 0, 0, 0, 26, 86, 0, 10, 0, 0, 11, 306, 8, 0, 1, 61, 22, 1, 0, 0, 8, 0, 38, 0, 80, 0, 0, 0, 17, 38, 0, 0, 0, 1, 0, 30, 8, 77, 0, 0, 3, 0, 0, 14, 6, 22, 0, 74, 0, 0, 0, 0, 3, 0, 69, 184, 21, 2, 0, 0, 0, 0, 0, 16, 32, 1, 0, 1, 0, 27, 0, 1, 0, 0, 2, 0, 0, 0, 0, 0, 0, 0, 0, 1, 12, 1, 0, 1, 0, 0, 0, 4, 55, 0, 3, 1, 0, 0, 1, 0, 0, 0, 6, 4, 13, 0, 0, 49, 3, 0, 0, 15, 2, 0, 21, 0, 10, 15, 130, 4, 0, 0, 0, 0, 0, 0, 0, 0, 0, 0, 0, 0, 45, 36, 0, 75, 4, 26, 0, 11, 0, 0, 2, 5, 28, 0, 36, 26, 0, 0, 0, 13, 5, 0, 0, 23, 1, 0, 0, 0, 33, 0, 1, 0, 0, 7, 0, 0, 0, 0, 2, 1, 17, 31, 0, 0, 0, 0, 0, 1, 0, 56, 0, 0, 0, 10, 6, 0, 213, 0, 8, 1, 0, 0, 2, 0, 0, 29, 0, 0, 0, 3, 0, 0, 0, 14, 1, 0, 0, 310, 20, 0, 0, 77, 0, 0, 0, 1, 14, 0, 33, 0, 0, 81, 7, 1, 112, 6, 0, 2, 0, 1, 0, 17, 1, 123, 0, 7, 0, 0, 3, 0, 0, 91, 0, 0, 0, 19, 6, 30, 82, 19, 7, 0, 0, 0, 0, 0, 2, 0, 7, 5, 0, 0, 2, 0, 0, 4, 0, 0, 0, 0, 8, 0, 0, 0, 81, 56, 47, 1, 2, 15, 24, 0, 0, 3, 6, 0, 0, 0, 0, 0, 0, 0, 0, 0, 11, 1, 27, 64, 8, 1, 0, 0, 108, 0, 0, 0, 30, 0, 5, 0, 123, 0, 10, 0, 0, 0, 10, 50, 0, 0, 0, 0, 0, 0, 0, 0, 3, 201, 0, 0, 8, 0, 0, 11, 9, 28, 107, 0, 0, 5, 16, 0, 61, 0, 2, 0, 1, 0, 3, 0, 2, 0, 0, 0, 0, 2, 1, 0, 0, 21, 10, 61, 0, 0, 22, 0, 32, 1, 0, 0, 1, 8, 0, 0, 0, 0, 3, 0, 0, 10, 0, 0, 0, 3, 2, 0, 17, 0, 0, 4, 1, 19, 0, 0, 4, 2, 41, 0, 0, 30, 5, 7, 0, 0, 0, 1, 0, 364, 10, 0, 0, 0, 0, 0, 296, 22, 0, 0, 0, 3, 8, 0, 2, 3, 0, 29, 0, 0, 0, 0, 0, 26, 2, 0, 0, 19, 0, 0, 0, 1, 0, 1, 1, 0, 32, 3, 0, 0, 5, 0, 0, 0, 0, 0, 0, 16, 0, 0, 3, 21, 19, 0, 1, 0, 0, 2, 0, 7, 0, 7, 0, 0, 0, 0, 14, 0, 0, 0, 1, 0, 5, 2, 2, 1, 16, 12, 7, 0, 183, 0, 0, 0, 142, 7, 26, 0, 20, 5, 3, 0, 0, 2, 0, 0, 94, 1, 0, 0, 0, 0, 0, 0, 0, 71, 0, 2, 0, 0, 0, 8, 1, 9, 1, 0, 0, 19, 1, 0, 5, 5, 88, 266, 0, 0, 50, 104, 0, 0, 2, 0, 0, 0, 13, 18, 1, 0, 0, 0, 8, 0, 0, 1, 0, 49, 28, 224, 0, 4, 17, 0, 0, 66, 0, 32, 0, 0, 0, 0, 0, 1, 125, 1, 210, 49, 0, 0, 0, 0, 1, 0, 0, 4, 61, 0, 0, 0, 0, 0, 52, 4, 47, 0, 0, 0, 10, 0, 0, 0, 0, 2, 61, 0, 15, 13, 1, 0, 24, 0, 0, 2, 0, 8, 86, 0, 8, 2, 2, 16, 0, 6, 1, 0, 15, 0, 0, 2, 0, 39, 0, 19, 0, 0, 4, 387, 0, 0, 0, 13, 0, 0, 2, 94, 0, 0, 0, 9, 82, 0, 27, 0, 0, 0, 0, 0, 0, 0, 9, 1, 11, 50, 33, 1
Changing How the World Does Business Fedexs Incredible Journey to Success - The Inside Story by Roger Frock (z-lib.org), 0, 0, 0, 19, 102, 0, 0, 0, 0, 31, 0, 8, 0, 0, 0, 16, 1, 0, 0, 0, 0, 0, 0, 62, 4, 0, 0, 0, 7, 0, 0, 0, 1, 0, 0, 0, 0, 0, 24, 0, 293, 0, 8, 0, 3, 0, 0, 5, 0, 0, 0, 27, 0, 0, 0, 0, 0, 0, 0, 0, 24, 0, 0, 0, 34, 0, 0, 29, 0, 0, 0, 0, 0, 0, 0, 0, 0, 0, 12, 0, 0, 0, 0, 0, 0, 33, 0, 0, 0, 22, 0, 0, 4, 0, 0, 0, 1, 0, 2, 9, 0, 0, 0, 0, 0, 0, 0, 0, 5, 0, 0, 47, 0, 0, 0, 3, 0, 0, 52, 0, 0, 0, 0, 0, 8, 134, 2, 0, 0, 0, 0, 0, 0, 0, 11, 0, 0, 0, 0, 11, 0, 0, 0, 0, 0, 44, 70, 0, 0, 0, 16, 0, 1, 0, 4, 29, 7, 0, 14, 1, 0, 19, 0, 0, 0, 0, 13, 0, 3, 1, 0, 0, 0, 31, 3, 0, 0, 0, 19, 10, 0, 27, 0, 37, 0, 0, 0, 3, 0, 0, 0, 0, 2, 1, 14, 1, 0, 4, 11, 0, 0, 6, 0, 35, 0, 0, 57, 0, 4, 1, 10, 7, 2, 0, 1, 0, 0, 0, 0, 7, 0, 0, 0, 0, 4, 0, 23, 0, 0, 0, 0, 0, 0, 0, 0, 0, 6, 0, 0, 0, 0, 4, 1, 1, 2, 0, 0, 0, 0, 0, 24, 0, 0, 0, 13, 0, 46, 0, 0, 0, 0, 60, 6, 0, 0, 0, 11, 0, 0, 12, 0, 0, 12, 2, 16, 10, 0, 0, 4, 0, 15, 0, 0, 0, 1, 0, 0, 0, 1, 11, 0, 18, 0, 11, 0, 1, 0, 39, 0, 12, 0, 6, 0, 0, 0, 21, 49, 0, 0, 3, 21, 0, 0, 0, 0, 77, 0, 193, 0, 0, 45, 0, 0, 4, 0, 0, 0, 0, 13, 0, 0, 1, 0, 11, 0, 0, 0, 0, 0, 0, 0, 0, 0, 0, 0, 0, 47, 0, 0, 0, 0, 13, 0, 0, 60, 0, 0, 53, 0, 0, 7, 0, 3, 0, 0, 0, 3, 0, 50, 1, 0, 46, 0, 2, 0, 0, 5, 0, 0, 75, 0, 0, 0, 0, 0, 10, 0, 0, 2, 0, 4, 7, 0, 0, 0, 0, 0, 0, 0, 0, 0, 0, 0, 0, 0, 0, 0, 0, 0, 30, 3, 0, 0, 0, 11, 0, 0, 0, 0, 0, 0, 0, 0, 0, 0, 88, 1, 0, 30, 0, 0, 0, 0, 0, 0, 0, 0, 0, 14, 0, 0, 12, 0, 0, 18, 0, 0, 0, 0, 0, 0, 0, 1, 4, 9, 0, 45, 16, 0, 0, 0, 184, 0, 0, 2, 0, 24, 0, 0, 0, 1, 0, 0, 0, 0, 0, 0, 0, 0, 4, 0, 0, 0, 0, 0, 0, 3, 0, 2, 0, 0, 0, 0, 0, 0, 0, 0, 3, 106, 10, 0, 0, 0, 7, 0, 0, 0, 0, 0, 0, 0, 0, 0, 0, 23, 20, 0, 43, 0, 0, 0, 0, 12, 0, 0, 110, 0, 1, 0, 9, 13, 0, 0, 0, 0, 0, 1, 2, 0, 1, 1, 2, 0, 0, 0, 0, 0, 0, 0, 0, 0, 2, 5, 0, 0, 0, 57, 25, 8, 5, 2, 0, 0, 0, 0, 0, 0, 0, 0, 0, 21, 0, 1, 1, 0, 21, 400, 50, 0, 0, 0, 0, 0, 0, 0, 0, 0, 0, 0, 0, 0, 23, 2, 0, 0, 7, 0, 11, 0, 4, 0, 0, 1, 10, 0, 0, 0, 0, 1, 3, 7, 0, 6, 0, 5, 0, 0, 13, 2, 0, 0, 1, 0, 0, 47, 0, 0, 39, 1, 12, 0, 5, 0, 8, 0, 0, 16, 0, 0, 69, 0, 27, 0, 0, 7, 0, 34, 0, 0, 0, 0, 0, 0, 0, 2, 0, 0, 2, 0, 17, 0, 0, 23, 0, 0, 0, 0, 0, 1, 0, 0, 0, 55, 0, 0, 31, 0, 0, 0, 0, 0, 41, 0, 0, 28, 6, 0, 0, 28, 0, 0, 33, 0, 0, 1, 19, 20, 0, 0, 45, 133, 5, 0, 0, 0, 0, 42, 32, 0, 0, 0, 36, 0, 0, 18, 0, 24, 0, 0, 0, 19, 1, 0, 0, 0, 7, 0, 0, 0, 4, 0, 0, 47, 1, 0, 0, 0, 0, 0, 0, 0, 0, 0, 0, 0, 1, 3, 0, 0, 44, 0, 0, 12, 0, 0, 0, 0, 0, 1, 0, 1, 1, 0, 0, 82, 0, 0, 0, 12, 0, 1, 9, 0, 6, 0, 1, 10, 0, 0, 4, 1, 4, 0, 2, 0, 9, 0, 0, 49, 0, 0, 0, 0, 19, 0, 0, 19, 0, 0, 0, 0, 0, 0, 14, 0, 0, 0, 11, 0, 0, 0, 0, 0, 0, 0, 0, 0, 0, 10, 0, 0, 0, 3, 0, 0, 0, 0, 1, 5, 0, 4, 0, 15, 5, 0, 0, 0, 0, 0, 0, 0, 0, 0, 11, 0, 21, 1, 21, 21, 12, 1, 0, 0, 0, 13, 0, 1, 0, 19, 0, 0, 8, 0, 0, 0, 6, 6, 0, 0, 0, 0, 11, 0, 0, 0, 0, 0, 2, 1, 0, 0, 7, 11, 0, 0, 0, 0, 0, 1, 93, 7, 0, 2, 0, 0, 3, 0, 23, 0, 0, 0, 2, 18, 19, 0, 6, 0, 0, 0, 0, 0, 54, 0, 9, 0, 0, 0, 0, 2, 0, 0, 0, 0, 0, 0, 7, 0, 0, 0, 0, 0, 42, 0, 0, 12, 0, 0, 0, 0, 2, 0, 0, 21, 0, 0, 0, 0, 0, 0, 0, 1, 0, 0, 0, 1, 19, 0, 4, 0, 0, 21, 0, 0, 8, 0, 8, 0, 1, 0, 0, 0, 12, 8, 0, 1, 0, 0, 0, 33, 0, 0, 14, 13, 0, 0, 0, 31, 0, 0, 24, 0, 0, 39, 37, 0, 14, 0, 0, 0, 0, 34, 0, 0, 0, 69, 0, 0, 0, 24, 5, 0, 0, 0, 7, 1, 0, 0, 11, 5, 0, 1, 0, 0, 13, 0, 1, 0, 0, 0, 46, 2, 34, 0, 0, 0, 0, 0, 0, 5, 0, 86, 0, 0, 0, 0, 0, 0, 0, 0, 0, 1, 0, 308, 0, 0, 4, 0, 0, 0, 0, 0, 85, 0, 0, 2, 26, 0, 0, 0, 0, 0, 0, 22, 0, 0, 0, 38, 0, 11, 0, 0, 0, 3, 0, 0, 0, 0, 0, 36, 0, 0, 0, 0, 0, 10, 0, 5, 0, 0, 5, 62, 20, 0, 0, 26, 16, 0, 0, 0, 1, 0, 15, 0, 6, 0, 0, 0, 67, 9, 0, 0, 3, 0, 0, 0, 3, 27, 0, 0, 0, 0, 0, 17, 3, 7, 0, 59, 2, 0, 0, 0, 1, 0, 15, 66, 11, 0, 0, 0, 0, 0, 0, 9, 32, 0, 0, 0, 1, 6, 0, 0, 0, 0, 0, 0, 0, 0, 6, 0, 2, 0, 21, 8, 6, 0, 0, 0, 0, 0, 0, 0, 105, 0, 7, 0, 0, 0, 0, 0, 0, 0, 1, 0, 28, 0, 0, 3, 0, 0, 0, 5, 0, 0, 6, 0, 2, 2, 16, 1, 0, 0, 0, 0, 0, 0, 3, 1, 0, 0, 0, 0, 20, 1, 0, 37, 0, 3, 10, 0, 0, 0, 0, 5, 4, 0, 2, 1, 0, 0, 0, 14, 1, 0, 0, 17, 16, 0, 0, 4, 0, 0, 0, 0, 0, 3, 8, 0, 0, 3, 1, 0, 309, 12, 0, 0, 0, 0, 0, 0, 65, 13, 0, 0, 0, 0, 14, 0, 0, 0, 0, 1, 0, 0, 3, 0, 0, 14, 0, 13, 0, 0, 0, 0, 0, 2, 0, 0, 0, 310, 12, 0, 0, 7, 0, 0, 0, 0, 4, 0, 0, 0, 0, 56, 0, 0, 10, 0, 0, 63, 0, 0, 0, 0, 0, 101, 2, 0, 0, 0, 0, 0, 0, 41, 0, 0, 0, 34, 1, 0, 32, 2, 0, 0, 0, 0, 0, 3, 32, 0, 0, 0, 0, 0, 0, 0, 0, 0, 0, 0, 25, 0, 9, 0, 0, 2, 84, 1, 3, 0, 1, 16, 1, 52, 0, 20, 16, 0, 16, 0, 1, 0, 0, 0, 0, 0, 1, 0, 17, 0, 20, 1, 0, 0, 2, 0, 0, 0, 0, 0, 9, 0, 4, 0, 18, 0, 1, 0, 1, 35, 0, 0, 0, 0, 0, 0, 0, 0, 3, 21, 0, 2, 11, 0, 0, 20, 20, 2, 2, 0, 0, 0, 3, 0, 47, 0, 1, 0, 0, 0, 1, 0, 2, 49, 0, 0, 0, 0, 0, 0, 0, 3, 10, 5, 0, 0, 29, 0, 31, 0, 0, 0, 0, 1, 0, 0, 0, 0, 0, 3, 0, 0, 0, 0, 0, 2, 4, 1, 29, 0, 1, 0, 10, 1, 0, 0, 1, 0, 0, 0, 0, 9, 0, 25, 0, 0, 0, 1, 0, 113, 3, 1, 0, 0, 0, 0, 0, 3, 0, 0, 0, 0, 0, 7, 0, 1, 0, 7, 0, 0, 0, 0, 0, 5, 0, 0, 0, 6, 0, 0, 0, 0, 1, 0, 0, 0, 24, 2, 0, 0, 0, 0, 18, 0, 0, 16, 0, 9, 0, 0, 6, 0, 8, 0, 0, 0, 0, 0, 0, 4, 0, 0, 10, 0, 0, 1, 4, 0, 0, 0, 2, 0, 0, 0, 1, 0, 0, 1, 0, 0, 15, 0, 0, 22, 8, 48, 16, 0, 0, 0, 3, 0, 0, 0, 0, 0, 53, 0, 0, 0, 0, 0, 0, 0, 0, 14, 0, 1, 0, 0, 0, 2, 0, 0, 0, 0, 0, 0, 1, 0, 0, 4, 3, 24, 0, 0, 29, 28, 0, 0, 0, 0, 0, 0, 0, 5, 0, 0, 0, 0, 0, 0, 0, 0, 0, 5, 20, 0, 0, 0, 9, 0, 0, 25, 0, 17, 0, 0, 0, 0, 0, 0, 21, 0, 7, 22, 0, 0, 0, 0, 0, 5, 0, 4, 0, 0, 0, 25, 0, 0, 52, 0, 44, 0, 0, 0, 7, 0, 0, 0, 1, 9, 5, 0, 0, 1, 0, 0, 5, 0, 0, 0, 0, 46, 65, 0, 4, 0, 2, 36, 0, 1, 37, 0, 56, 0, 0, 27, 0, 7, 0, 55, 0, 0, 0, 0, 0, 0, 0, 18, 0, 0, 0, 10, 0, 0, 0, 1, 16, 0, 10, 0, 0, 0, 0, 0, 0, 0, 0, 0, 29, 32, 1, 0
Dan-Steinbock-The-Nokia-revolution_-the-story-of-an-extraordinary-company-that-transformed-an-indust, 0, 0, 0, 28, 73, 0, 0, 0, 0, 155, 0, 5, 0, 0, 0, 1, 7, 1, 0, 4, 0, 0, 0, 129, 0, 0, 0, 0, 5, 128, 0, 0, 0, 8, 0, 1973, 0, 12, 48, 0, 3, 0, 103, 0, 0, 0, 0, 41, 0, 0, 0, 44, 0, 0, 0, 0, 0, 0, 0, 0, 44, 0, 0, 0, 4, 0, 0, 112, 0, 1, 0, 0, 1, 0, 4, 0, 11, 0, 5, 0, 0, 0, 0, 0, 0, 13, 0, 121, 0, 58, 0, 0, 2, 0, 0, 0, 0, 2, 2, 0, 1, 0, 0, 0, 0, 0, 0, 0, 0, 0, 0, 8, 0, 5, 0, 12, 0, 4, 0, 0, 0, 0, 0, 0, 60, 13, 0, 0, 0, 0, 4, 0, 0, 1, 0, 0, 0, 0, 0, 4, 0, 0, 0, 0, 0, 12, 42, 0, 0, 0, 0, 0, 1, 0, 16, 21, 1, 0, 128, 6, 0, 18, 0, 0, 1, 0, 4, 0, 4, 14, 0, 0, 0, 57, 0, 0, 0, 1, 2, 35, 0, 13, 0, 56, 0, 0, 0, 6, 0, 12, 0, 0, 11, 14, 5, 0, 0, 8, 24, 0, 0, 0, 0, 145, 0, 0, 10, 0, 2, 46, 26, 18, 1, 0, 24, 0, 0, 0, 0, 1, 0, 0, 0, 0, 2, 0, 0, 0, 1, 0, 0, 0, 0, 0, 0, 0, 27, 0, 2, 0, 0, 14, 55, 1, 0, 0, 0, 0, 1, 0, 59, 0, 0, 0, 58, 0, 39, 0, 0, 0, 0, 26, 0, 1, 0, 0, 0, 0, 0, 19, 36, 0, 69, 5, 12, 2, 0, 0, 1, 0, 3, 0, 0, 0, 4, 0, 0, 0, 0, 18, 0, 4, 20, 0, 2, 4, 0, 109, 0, 7, 0, 305, 0, 0, 0, 161, 48, 0, 0, 86, 24, 0, 0, 0, 1, 27, 0, 2, 0, 0, 17, 0, 0, 15, 0, 0, 0, 0, 20, 0, 0, 4, 0, 2, 5, 0, 0, 0, 0, 0, 0, 0, 0, 0, 0, 0, 43, 2, 0, 5, 0, 0, 0, 0, 46, 0, 0, 115, 0, 0, 6, 0, 0, 0, 0, 401, 0, 0, 36, 0, 0, 0, 11, 5, 0, 0, 62, 0, 0, 97, 0, 0, 0, 0, 0, 92, 0, 0, 5, 0, 6, 36, 0, 0, 0, 0, 0, 0, 0, 0, 0, 0, 0, 0, 0, 0, 0, 13, 0, 8, 114, 0, 0, 0, 11, 0, 0, 0, 0, 0, 0, 0, 1, 1, 0, 1, 0, 0, 51, 0, 0, 0, 0, 0, 0, 0, 15, 0, 15, 0, 0, 72, 0, 0, 42, 0, 0, 0, 0, 0, 0, 1, 1, 0, 0, 0, 53, 19, 0, 0, 0, 147, 2, 2, 7, 0, 57, 0, 0, 383, 0, 0, 0, 0, 0, 0, 0, 0, 0, 3, 0, 0, 4, 0, 0, 0, 10, 0, 0, 0, 0, 0, 0, 0, 0, 0, 0, 4, 4, 11, 0, 0, 0, 1, 0, 0, 0, 0, 0, 0, 0, 0, 2, 0, 64, 20, 0, 0, 0, 0, 0, 0, 15, 2, 0, 48, 0, 3, 0, 1, 18, 0, 0, 0, 0, 0, 4, 25, 0, 0, 1, 8, 0, 0, 1, 0, 0, 0, 0, 0, 0, 8, 0, 0, 0, 0, 127, 0, 0, 13, 139, 0, 0, 0, 0, 0, 0, 0, 0, 0, 36, 1, 0, 2, 0, 0, 0, 30, 0, 0, 3, 0, 0, 0, 0, 0, 0, 0, 0, 0, 0, 3, 9, 0, 0, 8, 0, 18, 0, 6, 0, 0, 1, 42, 0, 0, 0, 0, 1, 5, 25, 5, 18, 0, 20, 0, 0, 33, 5, 0, 0, 19, 5, 0, 11, 0, 0, 40, 224, 3, 0, 50, 0, 1, 0, 0, 53, 0, 0, 0, 0, 43, 0, 0, 91, 0, 88, 6, 0, 0, 0, 0, 3, 0, 0, 0, 0, 11, 0, 0, 0, 1, 209, 0, 1, 0, 4, 0, 2, 0, 0, 0, 0, 0, 31, 60, 0, 0, 0, 0, 0, 13, 0, 0, 15, 1, 0, 0, 0, 0, 0, 129, 0, 0, 5, 14, 1, 0, 0, 0, 156, 7, 0, 0, 0, 0, 30, 45, 0, 0, 0, 65, 0, 0, 54, 0, 23, 0, 0, 0, 0, 1, 0, 0, 0, 47, 0, 2, 0, 118, 0, 0, 2, 8, 0, 0, 0, 0, 0, 0, 0, 0, 0, 0, 0, 32, 0, 0, 0, 21, 0, 5, 43, 0, 0, 0, 0, 0, 0, 0, 2, 0, 0, 0, 0, 0, 0, 0, 28, 0, 10, 0, 0, 7, 0, 1, 51, 0, 0, 7, 17, 3, 0, 1, 0, 64, 43, 0, 32, 38, 0, 0, 0, 3, 0, 0, 334, 0, 0, 0, 0, 0, 0, 0, 0, 0, 0, 34, 0, 0, 0, 1, 0, 0, 0, 0, 0, 0, 8, 0, 0, 0, 3, 0, 3, 0, 0, 16, 17, 0, 41, 0, 14, 6, 0, 0, 0, 0, 0, 0, 0, 0, 0, 0, 0, 0, 1, 7, 183, 118, 2, 0, 1, 0, 0, 0, 30, 0, 0, 0, 0, 9, 0, 0, 0, 0, 1, 0, 0, 0, 0, 4, 1, 0, 0, 0, 0, 0, 2, 5, 0, 16, 0, 0, 0, 0, 3, 0, 1, 77, 61, 0, 31, 0, 0, 4, 0, 5, 1, 0, 2, 2, 18, 0, 0, 6, 0, 0, 0, 0, 0, 0, 0, 60, 0, 0, 0, 0, 4, 0, 0, 0, 0, 0, 10, 24, 4, 1, 0, 0, 0, 0, 3, 0, 62, 0, 0, 1, 0, 11, 0, 0, 189, 0, 0, 0, 0, 0, 0, 0, 2, 0, 0, 6, 1, 1, 0, 2, 1, 0, 28, 2, 0, 2, 0, 3, 0, 0, 0, 0, 0, 4, 1, 0, 90, 0, 0, 0, 61, 0, 0, 0, 24, 0, 0, 0, 91, 0, 0, 38, 0, 0, 0, 74, 0, 163, 3, 0, 0, 0, 0, 0, 0, 0, 0, 0, 7, 1, 39, 14, 0, 0, 0, 16, 1, 0, 0, 19, 55, 0, 1, 0, 0, 29, 0, 0, 0, 1, 0, 13, 7, 2, 0, 0, 1, 3, 0, 0, 16, 0, 71, 0, 0, 0, 0, 0, 0, 71, 0, 5, 2, 0, 118, 0, 0, 13, 0, 0, 0, 11, 0, 1, 0, 6, 1, 16, 0, 0, 0, 0, 0, 0, 12, 1, 0, 0, 102, 0, 14, 0, 0, 0, 1, 0, 0, 0, 0, 0, 13, 0, 0, 0, 0, 0, 59, 0, 26, 0, 3, 2, 553, 64, 0, 0, 11, 41, 0, 0, 0, 0, 0, 39, 0, 14, 0, 0, 0, 55, 8, 0, 0, 0, 0, 0, 8, 0, 11, 0, 0, 0, 0, 0, 38, 5, 6, 1, 110, 39, 0, 0, 0, 4, 0, 6, 21, 68, 0, 0, 0, 0, 0, 0, 0, 152, 0, 0, 486, 14, 11, 0, 0, 3, 0, 0, 0, 0, 0, 0, 0, 0, 0, 0, 7, 24, 1, 0, 0, 0, 0, 0, 3, 120, 0, 91, 0, 0, 0, 0, 0, 0, 0, 1, 0, 56, 0, 0, 32, 4, 0, 0, 3, 168, 0, 58, 2, 2, 81, 22, 0, 0, 0, 0, 0, 0, 0, 2, 1, 0, 241, 0, 0, 80, 18, 0, 26, 0, 9, 0, 0, 0, 0, 0, 0, 3, 0, 4, 0, 49, 0, 0, 8, 0, 0, 0, 10, 6, 0, 0, 0, 6, 0, 0, 0, 0, 0, 0, 0, 0, 2, 1, 2, 1, 301, 0, 0, 0, 0, 0, 0, 0, 43, 0, 0, 0, 1, 25, 0, 0, 0, 0, 0, 0, 0, 0, 0, 0, 3, 0, 0, 0, 0, 4, 0, 0, 0, 0, 0, 0, 888, 50, 1, 0, 21, 0, 2, 0, 0, 1, 5, 0, 1, 0, 64, 0, 0, 7, 0, 0, 0, 0, 0, 0, 1, 0, 5, 0, 1, 97, 0, 2, 0, 0, 45, 0, 0, 0, 91, 0, 0, 45, 4, 0, 0, 0, 0, 0, 2, 0, 0, 0, 153, 0, 0, 0, 0, 3, 1, 0, 0, 0, 0, 114, 0, 0, 1, 14, 3, 0, 0, 0, 19, 0, 1, 0, 71, 124, 0, 0, 0, 17, 0, 0, 1, 0, 0, 0, 0, 79, 0, 26, 17, 0, 0, 18, 0, 0, 0, 1, 0, 119, 0, 10, 0, 104, 0, 0, 0, 12, 79, 0, 0, 0, 0, 0, 0, 0, 0, 13, 104, 0, 0, 43, 0, 0, 51, 21, 17, 11, 0, 0, 1, 5, 0, 18, 0, 0, 0, 1, 0, 0, 0, 297, 0, 0, 0, 0, 2, 3, 0, 0, 322, 55, 1, 0, 0, 4, 0, 78, 0, 0, 0, 0, 1, 0, 0, 0, 0, 0, 49, 1, 0, 0, 0, 0, 0, 228, 0, 10, 0, 5, 0, 161, 2, 0, 0, 2, 0, 0, 0, 0, 3, 0, 1, 2, 3, 0, 4, 0, 362, 75, 32, 0, 0, 0, 0, 0, 14, 0, 0, 0, 3, 0, 22, 0, 1, 0, 6, 0, 0, 0, 0, 0, 14, 2, 0, 0, 8, 0, 0, 0, 0, 3, 0, 0, 0, 31, 0, 0, 177, 0, 0, 0, 0, 1, 0, 0, 9, 0, 0, 0, 1, 36, 0, 0, 0, 0, 2, 0, 0, 0, 1, 0, 0, 0, 0, 5, 0, 0, 0, 0, 0, 0, 19, 4, 0, 78, 2, 0, 0, 5, 0, 0, 0, 44, 101, 34, 0, 0, 0, 0, 0, 0, 1, 0, 0, 17, 0, 0, 0, 0, 0, 0, 0, 0, 19, 0, 22, 0, 0, 0, 13, 0, 17, 0, 0, 0, 2, 0, 0, 0, 0, 10, 9, 0, 0, 55, 11, 1, 0, 0, 0, 0, 0, 1, 1, 0, 0, 0, 3, 57, 0, 0, 0, 0, 100, 30, 0, 0, 0, 8, 8, 0, 30, 0, 279, 0, 0, 0, 0, 0, 0, 86, 0, 16, 1, 4, 0, 0, 0, 0, 2, 0, 5, 5, 0, 0, 0, 0, 0, 14, 0, 45, 0, 0, 0, 20, 0, 0, 0, 2, 44, 3, 0, 0, 49, 7, 0, 27, 0, 0, 0, 0, 48, 113, 5, 8, 0, 21, 0, 0, 1, 2, 0, 6, 60, 0, 0, 1, 28, 0, 5, 0, 0, 12, 0, 0, 0, 0, 7, 0, 0, 14, 45, 0, 0, 0, 1, 11, 0, 16, 0, 1, 0, 0, 0, 0, 0, 2, 0, 33, 15, 47, 0
David-Enrich-Dark-Towers_-Deutsche-Bank_-Donald-Trump_-and-an-Epic-Trail-of-Destruction-_2020_-Custo, 0, 0, 0, 70, 104, 0, 0, 0, 0, 41, 0, 18, 0, 0, 0, 0, 2, 0, 0, 0, 0, 0, 0, 12, 0, 0, 0, 0, 1, 2, 24, 0, 1, 0, 0, 0, 0, 1, 29, 0, 9, 0, 20, 0, 0, 0, 0, 24, 0, 0, 0, 21, 0, 0, 0, 8, 0, 0, 0, 0, 57, 0, 0, 0, 156, 0, 0, 54, 1, 4, 0, 0, 1, 0, 0, 1, 0, 0, 58, 0, 0, 0, 0, 0, 0, 9, 0, 5, 0, 55, 2, 0, 4, 156, 0, 0, 0, 1, 3, 16, 5, 0, 0, 0, 0, 0, 0, 0, 51, 0, 0, 14, 0, 0, 0, 17, 0, 10, 1, 0, 0, 0, 0, 0, 2, 130, 0, 0, 0, 0, 1, 0, 6, 4, 0, 0, 0, 0, 0, 9, 0, 0, 0, 0, 1, 6, 52, 211, 0, 0, 0, 0, 2, 0, 28, 46, 8, 0, 30, 0, 0, 21, 33, 0, 2, 0, 9, 0, 44, 7, 0, 0, 0, 16, 0, 0, 2, 0, 22, 17, 0, 30, 0, 30, 0, 0, 0, 7, 0, 16, 0, 0, 4, 1, 39, 2, 0, 1, 14, 0, 0, 6, 1, 57, 1, 0, 3, 36, 6, 1, 8, 8, 8, 0, 2, 0, 0, 0, 0, 25, 0, 0, 0, 0, 3, 0, 0, 0, 3, 0, 2, 0, 0, 0, 0, 0, 7, 0, 0, 0, 0, 7, 2, 1, 0, 0, 0, 1, 0, 0, 23, 0, 0, 0, 38, 0, 25, 0, 0, 0, 0, 8, 18, 0, 0, 0, 1, 0, 0, 24, 1, 0, 58, 4, 36, 31, 7, 0, 0, 0, 33, 0, 0, 0, 23, 0, 0, 0, 0, 11, 0, 15, 1, 0, 1, 5, 0, 16, 7, 5, 0, 22, 0, 0, 0, 61, 15, 0, 0, 3, 24, 0, 0, 0, 1, 15, 0, 8, 0, 0, 1, 0, 0, 4, 4, 0, 0, 0, 23, 0, 0, 9, 0, 1, 5, 0, 0, 0, 0, 0, 7, 0, 0, 0, 0, 0, 14, 109, 0, 27, 0, 14, 6, 0, 43, 0, 0, 91, 0, 0, 17, 0, 12, 0, 0, 0, 5, 0, 4, 3, 0, 0, 0, 3, 0, 0, 23, 17, 0, 23, 0, 0, 13, 0, 0, 18, 0, 0, 2, 0, 145, 4, 0, 0, 0, 0, 1, 0, 0, 163, 0, 0, 0, 0, 0, 0, 0, 0, 0, 102, 0, 1, 0, 2, 2, 1, 0, 0, 0, 0, 0, 0, 1, 0, 0, 29, 0, 0, 24, 0, 0, 4, 0, 0, 0, 0, 1, 0, 25, 6, 0, 14, 0, 1, 28, 0, 1, 0, 0, 0, 0, 0, 0, 0, 53, 0, 32, 15, 0, 0, 0, 206, 6, 0, 3, 0, 31, 0, 0, 0, 0, 0, 1, 0, 0, 114, 0, 0, 1, 22, 0, 0, 12, 0, 0, 0, 32, 0, 0, 10, 0, 0, 0, 0, 31, 0, 14, 1, 6, 134, 0, 1, 0, 16, 0, 0, 0, 0, 0, 0, 0, 0, 0, 0, 17, 52, 0, 8, 1, 0, 3, 0, 12, 0, 0, 22, 0, 0, 0, 2, 4, 0, 0, 2, 0, 0, 0, 9, 0, 0, 49, 3, 0, 2, 1, 3, 0, 0, 0, 0, 0, 0, 8, 13, 0, 0, 29, 0, 0, 1, 3, 0, 0, 3, 0, 0, 0, 8, 0, 0, 38, 0, 0, 1, 0, 0, 3, 28, 0, 0, 3, 0, 0, 0, 13, 2, 0, 0, 0, 0, 0, 0, 24, 0, 0, 9, 0, 4, 0, 39, 0, 0, 0, 21, 0, 0, 0, 0, 0, 83, 26, 0, 118, 1, 3, 0, 0, 5, 8, 0, 0, 0, 0, 0, 61, 1, 0, 16, 4, 11, 0, 17, 0, 16, 0, 0, 35, 0, 0, 12, 21, 34, 0, 0, 17, 0, 31, 1, 0, 0, 0, 0, 43, 0, 0, 2, 1, 31, 0, 0, 0, 1, 15, 0, 1, 0, 1, 0, 2, 0, 0, 0, 0, 0, 4, 14, 26, 0, 0, 0, 0, 93, 0, 0, 51, 2, 0, 0, 0, 1, 0, 13, 0, 0, 4, 0, 0, 0, 0, 0, 40, 15, 0, 28, 0, 0, 68, 7, 0, 0, 0, 46, 0, 0, 37, 0, 47, 0, 0, 0, 0, 0, 0, 0, 0, 42, 0, 2, 0, 15, 0, 0, 23, 3, 0, 0, 0, 0, 0, 0, 0, 0, 0, 0, 0, 13, 0, 0, 0, 12, 0, 9, 18, 10, 0, 0, 0, 2, 0, 0, 10, 0, 0, 0, 0, 0, 0, 0, 114, 0, 0, 0, 0, 27, 3, 1, 8, 0, 0, 8, 3, 1, 0, 5, 0, 31, 1, 0, 21, 3, 0, 0, 1, 2, 1, 0, 39, 0, 0, 0, 0, 0, 0, 0, 0, 0, 0, 12, 0, 0, 0, 10, 0, 0, 0, 0, 0, 79, 14, 0, 0, 0, 20, 0, 3, 0, 26, 7, 20, 0, 72, 0, 24, 1, 0, 1, 0, 2, 0, 1, 1, 0, 1, 0, 1, 1, 2, 7, 21, 4, 15, 0, 2, 0, 0, 0, 17, 0, 0, 0, 0, 38, 0, 0, 0, 0, 1, 0, 0, 0, 0, 19, 0, 2, 0, 0, 5, 23, 0, 4, 72, 11, 7, 1, 0, 2, 3, 0, 0, 76, 6, 0, 53, 5, 0, 19, 0, 12, 1, 0, 1, 28, 6, 0, 0, 3, 0, 0, 2, 0, 0, 0, 0, 81, 0, 0, 0, 0, 3, 0, 0, 0, 0, 0, 0, 54, 1, 0, 0, 0, 0, 0, 9, 0, 13, 0, 0, 0, 2, 7, 0, 0, 10, 0, 0, 1, 0, 0, 0, 0, 4, 0, 0, 0, 4, 0, 0, 76, 2, 0, 19, 4, 0, 6, 8, 3, 0, 0, 0, 0, 0, 3, 0, 0, 11, 0, 0, 0, 32, 0, 0, 0, 5, 0, 0, 0, 19, 0, 0, 52, 0, 0, 0, 45, 0, 9, 54, 0, 0, 0, 2, 0, 0, 0, 0, 0, 3, 32, 24, 1, 0, 0, 0, 1, 3, 8, 0, 2, 2, 0, 0, 1, 0, 92, 0, 0, 2, 0, 0, 27, 10, 0, 0, 0, 4, 0, 0, 0, 1, 0, 25, 0, 0, 0, 0, 0, 0, 0, 0, 0, 3, 0, 22, 0, 0, 69, 0, 0, 0, 64, 0, 1, 0, 0, 0, 16, 1, 0, 1, 0, 0, 0, 63, 0, 0, 0, 13, 0, 22, 0, 0, 0, 9, 0, 0, 0, 0, 0, 55, 0, 0, 0, 0, 0, 174, 0, 2, 0, 15, 5, 67, 1, 0, 0, 29, 71, 0, 0, 0, 1, 0, 13, 0, 104, 0, 0, 0, 65, 34, 0, 0, 0, 154, 0, 0, 41, 42, 0, 0, 17, 0, 11, 12, 1, 8, 914, 206, 0, 0, 0, 0, 3, 0, 23, 56, 6, 0, 0, 0, 0, 0, 0, 35, 10, 7, 0, 0, 14, 12, 0, 0, 1, 0, 0, 0, 0, 1, 0, 55, 0, 0, 0, 13, 2, 0, 0, 4, 0, 0, 0, 0, 33, 0, 0, 1, 0, 0, 0, 0, 0, 0, 5, 0, 3, 1, 0, 2, 0, 5, 0, 6, 0, 0, 6, 0, 8, 23, 72, 0, 0, 0, 0, 0, 0, 0, 46, 1, 0, 0, 0, 0, 26, 7, 0, 35, 9, 22, 0, 1, 0, 0, 0, 4, 14, 0, 29, 2, 0, 0, 0, 2, 13, 0, 0, 35, 2, 0, 26, 1, 2, 0, 0, 0, 0, 2, 0, 0, 0, 0, 2, 1, 30, 20, 0, 0, 1, 0, 0, 0, 0, 42, 0, 0, 0, 17, 6, 0, 0, 0, 0, 1, 0, 0, 0, 0, 0, 3, 0, 0, 135, 0, 0, 0, 0, 8, 0, 0, 0, 157, 15, 0, 0, 23, 0, 0, 0, 0, 8, 0, 9, 1, 0, 941, 79, 0, 91, 4, 0, 1, 0, 1, 0, 0, 0, 33, 0, 7, 0, 0, 3, 0, 0, 59, 2, 0, 0, 13, 3, 19, 85, 123, 30, 0, 0, 0, 0, 0, 1, 0, 0, 1, 0, 0, 436, 0, 0, 0, 0, 0, 0, 1, 15, 0, 0, 0, 67, 28, 14, 0, 1, 6, 4, 0, 0, 34, 8, 0, 0, 0, 1, 0, 0, 0, 0, 0, 5, 0, 4, 0, 5, 1, 0, 0, 23, 0, 0, 0, 2, 0, 30, 0, 115, 0, 34, 0, 4, 0, 5, 82, 0, 0, 0, 0, 0, 0, 0, 0, 154, 99, 0, 0, 7, 0, 0, 14, 8, 36, 17, 0, 0, 0, 13, 0, 94, 0, 0, 0, 13, 0, 6, 0, 2, 0, 0, 0, 0, 1, 2, 0, 0, 21, 3, 12, 0, 0, 22, 0, 9, 2, 28, 0, 0, 1, 0, 0, 0, 0, 0, 0, 88, 18, 0, 0, 0, 0, 26, 1, 5, 0, 5, 0, 27, 3, 0, 0, 5, 153, 0, 0, 0, 20, 3, 5, 0, 0, 0, 1, 0, 170, 2, 4, 0, 0, 28, 0, 2, 99, 0, 0, 0, 4, 0, 4, 1, 2, 0, 14, 0, 0, 0, 0, 0, 16, 0, 1, 0, 13, 0, 0, 0, 0, 0, 0, 3, 0, 21, 1, 0, 0, 0, 0, 0, 1, 0, 0, 0, 21, 0, 0, 23, 10, 1, 0, 7, 0, 0, 0, 0, 2, 0, 1, 0, 0, 0, 0, 12, 0, 0, 0, 2, 0, 4, 0, 6, 5, 13, 6, 0, 4, 52, 0, 0, 0, 16, 17, 61, 2, 0, 0, 2, 0, 0, 4, 0, 0, 44, 6, 0, 0, 0, 0, 0, 0, 0, 25, 0, 7, 0, 0, 0, 9, 4, 2, 0, 0, 0, 6, 0, 0, 4, 0, 7, 248, 0, 0, 18, 48, 0, 0, 10, 0, 0, 3, 5, 26, 0, 0, 0, 0, 1, 0, 0, 0, 0, 44, 10, 0, 0, 1, 16, 0, 0, 41, 0, 55, 0, 0, 0, 0, 0, 0, 30, 0, 113, 41, 1, 0, 0, 0, 0, 0, 0, 90, 0, 0, 0, 0, 0, 1, 59, 1, 24, 0, 0, 0, 57, 0, 0, 0, 2, 0, 18, 0, 0, 8, 0, 0, 23, 0, 0, 3, 0, 39, 30, 0, 2, 1, 2, 2, 0, 10, 1, 0, 3, 0, 0, 4, 0, 26, 0, 19, 0, 0, 0, 0, 0, 0, 0, 14, 0, 0, 1, 99, 0, 0, 0, 77, 45, 0, 12, 0, 0, 0, 0, 0, 0, 0, 3, 0, 4, 55, 13, 6
Decoding Coca-Cola A Biography of a Global Brand by Robert Crawford- Linda Brennan and Susie Khamis (z-lib.org), 0, 0, 0, 47, 7, 0, 0, 0, 0, 41, 1, 7, 1, 0, 0, 9, 2, 0, 0, 0, 0, 0, 0, 19, 1, 0, 0, 0, 13, 0, 0, 37, 0, 0, 0, 0, 0, 76, 92, 0, 15, 0, 127, 0, 0, 0, 0, 0, 0, 0, 0, 9, 0, 0, 0, 0, 0, 0, 0, 0, 58, 0, 0, 0, 1, 0, 0, 69, 0, 0, 0, 0, 0, 0, 2, 0, 0, 0, 6, 0, 0, 0, 0, 0, 0, 3, 0, 1, 0, 37, 0, 0, 22, 0, 0, 0, 1, 0, 2, 0, 0, 1, 0, 0, 0, 0, 0, 36, 0, 0, 0, 4, 0, 0, 0, 17, 0, 0, 0, 0, 0, 0, 0, 0, 38, 28, 0, 0, 0, 0, 2, 0, 0, 0, 0, 0, 0, 0, 0, 11, 0, 23, 0, 0, 0, 3, 15, 0, 0, 0, 4, 0, 2, 0, 66, 5, 0, 0, 28, 3, 0, 13, 0, 0, 0, 0, 4, 2, 10, 2, 0, 15, 0, 24, 0, 0, 0, 0, 15, 3, 0, 10, 0, 19, 0, 38, 0, 10, 0, 3, 0, 1, 1, 10, 3, 1, 0, 2, 21, 0, 0, 1, 0, 58, 0, 0, 4, 0, 4, 13, 22, 8, 10, 7, 0, 0, 0, 0, 0, 1, 0, 0, 0, 0, 1, 0, 0, 0, 1, 4, 0, 16, 3, 6, 0, 0, 61, 0, 0, 0, 0, 24, 4, 0, 0, 0, 0, 0, 1, 23, 5, 0, 0, 0, 5, 0, 24, 0, 0, 0, 0, 9, 1, 0, 0, 0, 1, 0, 0, 4, 32, 0, 45, 2, 6, 5, 0, 1, 9, 0, 43, 0, 0, 0, 2, 0, 0, 2, 0, 124, 0, 22, 0, 0, 0, 1, 0, 50, 1, 32, 2, 21, 0, 0, 0, 103, 34, 0, 0, 23, 16, 0, 0, 0, 0, 5, 0, 3, 0, 1, 31, 0, 0, 21, 0, 0, 0, 0, 12, 0, 0, 45, 0, 5, 3, 0, 0, 0, 0, 0, 3, 0, 0, 0, 0, 0, 23, 3, 0, 11, 0, 2, 4, 0, 8, 0, 0, 3, 0, 0, 29, 0, 0, 72, 0, 0, 35, 1, 5, 2, 0, 0, 0, 1, 0, 0, 66, 1, 0, 57, 0, 0, 0, 6, 0, 5, 4, 0, 4, 0, 0, 15, 0, 0, 2, 0, 0, 0, 0, 0, 0, 26, 0, 0, 0, 0, 0, 0, 0, 23, 6, 0, 0, 1, 15, 0, 0, 0, 0, 0, 0, 0, 1, 0, 0, 2, 0, 0, 45, 0, 0, 0, 0, 3, 2, 0, 0, 0, 6, 1, 0, 50, 0, 0, 90, 1, 0, 0, 0, 0, 0, 0, 0, 0, 3, 0, 64, 164, 0, 0, 0, 129, 0, 3, 0, 0, 10, 0, 0, 0, 0, 0, 0, 0, 0, 0, 0, 0, 0, 1, 0, 0, 1, 0, 0, 0, 0, 0, 0, 0, 0, 0, 5, 12, 0, 0, 3, 1, 20, 0, 0, 0, 0, 5, 0, 0, 0, 0, 0, 0, 0, 0, 12, 0, 48, 9, 0, 2, 0, 0, 0, 49, 76, 1, 0, 23, 0, 0, 0, 0, 3, 0, 0, 0, 0, 1, 102, 114, 0, 0, 0, 68, 0, 1, 0, 1, 0, 0, 0, 2, 0, 2, 4, 1, 0, 0, 49, 5, 38, 32, 9, 0, 0, 0, 0, 2, 0, 53, 0, 0, 12, 0, 0, 57, 0, 0, 0, 0, 96, 0, 3, 1, 0, 0, 0, 0, 0, 0, 0, 0, 0, 12, 217, 0, 0, 1, 2, 20, 0, 1, 0, 0, 97, 49, 0, 0, 0, 0, 0, 2, 115, 1094, 6, 1, 18, 0, 0, 23, 1, 0, 178, 4, 0, 0, 6, 0, 0, 37, 1, 3, 0, 49, 46, 0, 0, 0, 10, 0, 0, 1, 0, 7, 0, 0, 6, 0, 48, 3, 0, 0, 0, 0, 7, 0, 0, 0, 0, 0, 0, 4, 0, 0, 55, 0, 0, 0, 1, 0, 1, 0, 2, 0, 0, 0, 0, 20, 2, 1, 0, 0, 0, 4, 0, 0, 7, 8, 0, 0, 6, 2, 0, 131, 0, 0, 2, 2, 11, 0, 0, 0, 12, 11, 0, 0, 0, 0, 24, 70, 0, 21, 0, 23, 0, 0, 23, 0, 7, 0, 0, 0, 0, 1, 0, 13, 0, 115, 0, 26, 3, 3, 0, 0, 0, 50, 0, 0, 0, 0, 11, 0, 0, 0, 0, 0, 0, 21, 1, 0, 5, 5, 0, 2, 5, 0, 0, 2, 0, 0, 0, 0, 10, 0, 0, 0, 0, 0, 0, 0, 18, 0, 1, 0, 0, 5, 1, 3, 26, 0, 0, 11, 1, 16, 0, 18, 7, 42, 1, 0, 22, 15, 0, 0, 0, 0, 0, 2, 47, 0, 0, 0, 0, 0, 0, 0, 0, 0, 0, 8, 7, 0, 0, 40, 9, 1, 0, 0, 0, 0, 1, 0, 0, 0, 3, 0, 9, 0, 0, 0, 14, 5, 0, 0, 5, 0, 0, 0, 2, 1, 0, 1, 0, 0, 0, 0, 0, 0, 6, 4, 68, 12, 60, 1, 0, 0, 64, 0, 13, 0, 1, 0, 0, 0, 46, 0, 0, 0, 133, 0, 0, 0, 0, 0, 3, 726, 0, 0, 15, 5, 1, 6, 0, 41, 0, 0, 0, 0, 1, 0, 1, 73, 24, 0, 7, 0, 0, 19, 0, 4, 1, 0, 34, 3, 9, 0, 0, 5, 0, 0, 0, 0, 0, 0, 0, 16, 0, 0, 23, 0, 0, 0, 0, 5, 0, 0, 0, 5, 0, 0, 0, 0, 0, 0, 9, 13, 33, 0, 0, 63, 0, 18, 0, 0, 26, 0, 0, 0, 0, 0, 0, 0, 7, 0, 0, 0, 2, 21, 0, 5, 0, 0, 68, 0, 0, 2, 0, 7, 0, 0, 0, 0, 0, 18, 10, 0, 7, 0, 0, 0, 7, 0, 0, 0, 5, 0, 0, 2, 78, 0, 0, 20, 0, 0, 1, 70, 0, 41, 2, 0, 0, 0, 0, 0, 0, 0, 0, 0, 2, 17, 52, 7, 0, 0, 0, 3, 0, 0, 0, 204, 19, 4, 93, 10, 0, 23, 0, 0, 0, 1, 25, 4, 76, 0, 0, 0, 1, 0, 0, 0, 5, 0, 49, 0, 0, 0, 0, 0, 0, 0, 0, 0, 2, 0, 17, 0, 0, 13, 0, 1, 0, 0, 0, 0, 0, 14, 0, 93, 1, 3, 0, 0, 0, 0, 45, 6, 0, 0, 63, 0, 4, 0, 0, 0, 7, 0, 0, 0, 0, 0, 6, 0, 0, 0, 0, 0, 1, 0, 6, 0, 3, 5, 186, 146, 0, 0, 18, 49, 3, 0, 0, 0, 0, 25, 0, 0, 0, 0, 0, 3, 4, 0, 0, 0, 0, 0, 0, 0, 27, 0, 0, 0, 0, 0, 33, 16, 8, 0, 30, 8, 0, 0, 0, 1, 0, 24, 3, 10, 0, 0, 0, 0, 0, 0, 3, 59, 0, 0, 0, 0, 0, 0, 1, 82, 0, 0, 0, 0, 0, 3, 0, 0, 0, 0, 3, 5, 6, 0, 0, 0, 0, 0, 0, 11, 0, 6, 72, 0, 0, 0, 0, 0, 0, 9, 2, 15, 14, 0, 1, 2, 0, 0, 3, 0, 0, 9, 0, 8, 464, 8, 0, 0, 0, 0, 0, 0, 0, 0, 1, 0, 0, 0, 0, 56, 0, 0, 16, 0, 1, 0, 0, 0, 0, 0, 1, 3, 0, 13, 164, 0, 0, 0, 16, 2, 0, 0, 5, 12, 0, 0, 0, 0, 0, 0, 0, 0, 3, 3, 0, 0, 6, 0, 0, 1, 237, 0, 0, 0, 0, 0, 0, 0, 25, 0, 0, 0, 2, 3, 0, 0, 0, 0, 5, 0, 0, 0, 0, 0, 6, 0, 0, 0, 17, 0, 0, 0, 1, 1, 0, 0, 307, 15, 0, 0, 17, 0, 1, 0, 0, 2, 0, 0, 0, 0, 1, 0, 38, 3, 1, 0, 0, 0, 0, 0, 0, 0, 13, 0, 6, 0, 0, 0, 0, 0, 90, 1, 0, 0, 0, 7, 1, 14, 2, 0, 0, 0, 0, 2, 100, 0, 0, 16, 0, 0, 0, 39, 0, 0, 114, 0, 0, 0, 0, 17, 0, 0, 3, 7, 170, 8, 1, 47, 34, 2, 11, 0, 10, 41, 0, 1, 0, 12, 0, 0, 0, 0, 0, 1, 0, 20, 0, 22, 0, 68, 0, 2, 0, 0, 0, 162, 0, 41, 0, 1, 0, 47, 0, 2, 0, 0, 101, 0, 0, 0, 0, 0, 0, 0, 0, 4, 6, 0, 0, 38, 1, 0, 45, 5, 50, 4, 0, 0, 0, 14, 1, 7, 0, 10, 0, 1, 0, 4, 0, 5, 0, 71, 0, 0, 2, 0, 0, 0, 93, 4, 4, 0, 0, 1, 0, 24, 0, 0, 0, 0, 1, 0, 0, 0, 0, 7, 1, 0, 0, 0, 1, 0, 0, 191, 1, 0, 0, 0, 0, 32, 4, 0, 0, 8, 0, 0, 0, 0, 25, 5, 11, 0, 1, 0, 1, 0, 55, 177, 5, 0, 0, 0, 1, 0, 0, 0, 0, 0, 1, 0, 2, 0, 1, 0, 1, 0, 0, 0, 0, 0, 14, 2, 0, 0, 24, 0, 0, 0, 0, 1, 2, 0, 0, 32, 0, 0, 0, 1, 0, 0, 0, 0, 0, 0, 1, 0, 0, 0, 2, 2, 0, 0, 0, 0, 0, 0, 0, 0, 0, 2, 0, 0, 0, 12, 0, 0, 0, 0, 0, 0, 0, 0, 2, 40, 68, 0, 0, 15, 0, 0, 0, 8, 1, 11, 0, 0, 1, 2, 0, 0, 2, 0, 0, 6, 10, 0, 0, 0, 0, 0, 0, 0, 0, 0, 0, 0, 0, 0, 11, 0, 27, 0, 0, 0, 3, 0, 0, 0, 8, 0, 8, 0, 0, 31, 18, 0, 0, 0, 0, 0, 1, 0, 7, 2, 0, 0, 1, 0, 0, 1, 0, 10, 14, 34, 1, 0, 0, 5, 0, 6, 45, 0, 2, 0, 0, 0, 0, 0, 0, 68, 0, 15, 4, 0, 0, 0, 0, 0, 3, 0, 0, 1040, 0, 0, 0, 0, 17, 23, 0, 81, 0, 0, 0, 5, 1, 0, 0, 0, 4, 15, 0, 2, 0, 0, 3, 113, 0, 1, 0, 0, 21, 82, 0, 35, 1, 21, 0, 0, 2, 0, 0, 49, 0, 0, 1, 0, 21, 1, 8, 0, 0, 33, 0, 0, 0, 0, 9, 0, 0, 1, 291, 0, 0, 0, 1, 12, 0, 63, 0, 0, 0, 0, 0, 0, 0, 7, 0, 5, 20, 45, 0
Elon-Musk-a-mission-to-save-the-world-_Anna-Crowley-Redding, 0, 0, 0, 1, 17, 0, 0, 0, 0, 20, 2, 3, 0, 0, 0, 0, 1, 0, 0, 0, 0, 0, 0, 9, 0, 0, 0, 0, 14, 1, 0, 0, 0, 0, 0, 0, 0, 1, 17, 0, 7, 0, 5, 0, 0, 0, 0, 0, 1, 0, 0, 2, 0, 0, 0, 0, 0, 0, 0, 0, 28, 0, 0, 0, 7, 0, 0, 17, 0, 0, 0, 0, 0, 0, 1, 0, 0, 0, 4, 0, 0, 0, 0, 0, 0, 4, 0, 0, 0, 31, 0, 0, 1, 0, 0, 0, 0, 0, 4, 13, 0, 0, 0, 0, 0, 0, 1, 0, 2, 0, 0, 12, 0, 0, 0, 4, 3, 3, 2, 0, 0, 0, 0, 0, 16, 56, 4, 0, 0, 0, 0, 0, 0, 0, 0, 0, 0, 0, 0, 3, 0, 0, 0, 0, 0, 2, 42, 0, 0, 0, 0, 0, 0, 0, 0, 1, 23, 0, 5, 0, 0, 22, 0, 0, 0, 0, 0, 6, 1, 0, 0, 1, 0, 10, 1, 0, 2, 0, 4, 4, 0, 2, 0, 10, 0, 0, 0, 7, 0, 0, 0, 0, 4, 0, 6, 0, 0, 0, 20, 0, 0, 2, 0, 17, 0, 0, 6, 0, 1, 5, 4, 8, 14, 0, 2, 0, 0, 0, 0, 3, 0, 0, 0, 0, 0, 0, 0, 0, 2, 0, 0, 0, 0, 0, 0, 0, 9, 0, 2, 0, 0, 3, 0, 0, 0, 0, 0, 1, 1, 0, 22, 0, 0, 0, 8, 0, 9, 0, 0, 0, 0, 4, 9, 0, 0, 0, 1, 0, 0, 28, 0, 0, 4, 1, 2, 23, 9, 0, 0, 6, 10, 0, 0, 0, 4, 0, 0, 0, 0, 17, 0, 1, 12, 0, 0, 0, 0, 15, 2, 7, 4, 53, 0, 0, 0, 14, 10, 0, 0, 4, 8, 0, 0, 0, 0, 0, 0, 0, 0, 1, 10, 0, 0, 3, 0, 0, 0, 0, 56, 0, 0, 29, 0, 1, 0, 0, 0, 0, 0, 0, 1, 0, 0, 0, 0, 0, 2, 0, 0, 1, 0, 3, 0, 0, 0, 0, 0, 21, 0, 0, 7, 0, 1, 0, 0, 0, 7, 0, 8, 1, 0, 0, 1, 0, 0, 0, 6, 9, 0, 13, 0, 0, 4, 0, 0, 0, 0, 0, 4, 0, 0, 13, 0, 0, 0, 0, 0, 0, 0, 0, 0, 0, 0, 0, 0, 0, 0, 0, 0, 11, 4, 0, 0, 15, 0, 0, 0, 0, 0, 0, 0, 0, 0, 1, 0, 11, 0, 0, 63, 0, 0, 1, 0, 0, 0, 0, 12, 1, 36, 3, 0, 3, 0, 1, 51, 0, 0, 0, 0, 0, 0, 0, 0, 0, 8, 2, 9, 4, 0, 0, 0, 95, 1, 0, 2, 0, 4, 0, 0, 0, 0, 0, 0, 0, 0, 0, 683, 0, 0, 8, 0, 5, 0, 0, 0, 0, 3, 0, 0, 0, 0, 0, 0, 0, 0, 0, 33, 0, 10, 2, 0, 0, 0, 4, 0, 0, 0, 0, 0, 0, 0, 0, 2, 0, 4, 49, 0, 3, 0, 0, 0, 3, 6, 0, 0, 1, 0, 0, 0, 5, 1, 0, 0, 0, 0, 0, 0, 3, 0, 0, 10, 0, 0, 0, 3, 0, 0, 0, 0, 0, 0, 0, 5, 0, 0, 0, 1, 0, 0, 0, 44, 0, 0, 0, 0, 0, 0, 10, 0, 0, 2, 0, 0, 0, 0, 0, 0, 22, 0, 0, 22, 0, 0, 0, 2, 0, 0, 0, 0, 0, 0, 0, 1, 0, 0, 2, 0, 9, 0, 5, 0, 0, 0, 3, 0, 0, 0, 0, 6, 1, 26, 0, 10, 1, 2, 0, 0, 5, 0, 0, 0, 3, 0, 0, 14, 0, 0, 13, 0, 19, 0, 14, 0, 5, 0, 0, 22, 0, 0, 2, 0, 8, 0, 0, 0, 0, 17, 0, 0, 0, 0, 0, 1, 0, 0, 0, 0, 6, 0, 0, 0, 0, 10, 0, 0, 0, 0, 0, 1, 0, 0, 0, 0, 0, 0, 14, 0, 0, 0, 0, 0, 18, 0, 0, 7, 0, 0, 0, 1, 0, 0, 22, 0, 30, 0, 1, 0, 0, 0, 2, 27, 2, 0, 0, 0, 0, 48, 12, 0, 0, 0, 8, 0, 1, 6, 0, 1, 0, 0, 0, 0, 0, 0, 0, 0, 10, 0, 3, 0, 2, 0, 0, 3, 6, 0, 0, 0, 0, 0, 0, 0, 0, 0, 0, 0, 1, 0, 0, 0, 13, 0, 2, 11, 0, 0, 0, 0, 0, 0, 0, 5, 0, 0, 0, 0, 0, 0, 0, 6, 0, 0, 0, 0, 6, 116, 5, 0, 0, 0, 6, 32, 0, 0, 11, 2, 39, 1, 0, 12, 0, 0, 0, 0, 7, 0, 0, 20, 0, 0, 0, 0, 0, 0, 0, 0, 0, 0, 16, 0, 0, 0, 2, 0, 1, 0, 0, 0, 0, 4, 0, 0, 0, 7, 0, 1, 0, 0, 3, 4, 0, 5, 0, 0, 1, 0, 2, 0, 0, 0, 0, 0, 0, 0, 0, 4, 0, 1, 0, 14, 4, 11, 0, 0, 0, 0, 0, 14, 0, 0, 0, 0, 1, 0, 0, 0, 0, 1, 0, 0, 0, 0, 7, 1, 0, 0, 0, 1, 2, 0, 1, 0, 2, 8, 0, 0, 0, 1, 0, 0, 100, 1, 0, 1, 0, 0, 25, 0, 7, 0, 0, 1, 0, 5, 0, 0, 10, 0, 0, 3, 0, 0, 0, 0, 14, 0, 0, 0, 0, 0, 0, 19, 0, 0, 0, 0, 3, 0, 1, 0, 0, 0, 0, 1, 1, 10, 0, 0, 0, 0, 20, 0, 2, 6, 0, 0, 0, 0, 0, 0, 0, 2, 0, 0, 1, 2, 0, 0, 13, 1, 55, 1, 0, 0, 3, 0, 13, 0, 0, 0, 0, 0, 2, 0, 0, 0, 0, 0, 0, 7, 0, 204, 0, 0, 0, 0, 0, 23, 25, 0, 27, 0, 0, 1, 21, 0, 15, 1, 0, 0, 0, 2, 0, 0, 0, 41, 0, 0, 6, 4, 0, 0, 0, 0, 5, 4, 0, 0, 1, 3, 0, 1, 0, 0, 19, 0, 0, 0, 0, 0, 13, 1, 0, 0, 0, 1, 0, 0, 0, 5, 0, 9, 0, 0, 0, 0, 0, 0, 1, 0, 0, 5, 0, 8, 1, 0, 1, 0, 0, 0, 5, 0, 0, 0, 1, 0, 3, 1, 0, 0, 0, 0, 0, 18, 0, 0, 0, 2, 0, 178, 0, 0, 0, 1, 0, 0, 0, 0, 0, 9, 0, 0, 0, 0, 0, 6, 0, 6, 0, 0, 15, 9, 3, 0, 0, 11, 5, 8, 0, 0, 0, 0, 4, 0, 22, 2, 0, 0, 1, 6, 0, 0, 0, 0, 0, 0, 0, 42, 0, 0, 0, 0, 0, 62, 3, 16, 0, 5, 3, 0, 0, 0, 4, 0, 15, 18, 2, 1, 0, 0, 0, 0, 0, 2, 15, 0, 0, 1, 0, 10, 0, 0, 0, 0, 0, 0, 0, 0, 0, 0, 0, 0, 0, 2, 9, 0, 0, 0, 0, 0, 0, 0, 1, 0, 1, 0, 0, 0, 0, 0, 0, 0, 0, 0, 15, 0, 0, 2, 0, 0, 0, 0, 0, 0, 8, 0, 0, 2, 11, 0, 0, 0, 0, 0, 0, 0, 0, 0, 0, 0, 0, 0, 9, 3, 0, 16, 1, 2, 7, 0, 0, 0, 0, 1, 15, 0, 6, 0, 0, 0, 0, 85, 0, 0, 0, 7, 7, 0, 0, 0, 0, 0, 0, 0, 0, 1, 0, 0, 0, 0, 6, 0, 3, 5, 0, 122, 3, 0, 0, 1, 0, 14, 0, 0, 0, 1, 31, 0, 0, 0, 0, 1, 0, 0, 0, 0, 0, 9, 0, 0, 0, 0, 0, 0, 0, 1, 0, 0, 0, 162, 2, 0, 0, 0, 0, 0, 0, 1, 1, 0, 0, 0, 0, 20, 0, 0, 9, 2, 0, 0, 1, 14, 0, 2, 0, 15, 0, 0, 0, 0, 0, 0, 0, 6, 0, 0, 0, 13, 1, 17, 76, 1, 0, 0, 0, 0, 1, 0, 0, 0, 0, 2, 0, 0, 0, 0, 2, 0, 0, 0, 0, 0, 2, 0, 0, 1, 12, 5, 1, 9, 0, 9, 0, 0, 0, 2, 3, 2, 0, 0, 2, 0, 0, 0, 0, 0, 0, 0, 1, 0, 3, 0, 0, 0, 3, 0, 0, 0, 1, 0, 2, 0, 15, 0, 12, 0, 0, 0, 0, 18, 0, 0, 0, 0, 0, 0, 0, 0, 0, 5, 0, 0, 77, 0, 0, 0, 3, 15, 7, 0, 0, 3, 8, 0, 29, 0, 1, 0, 0, 0, 2, 0, 0, 15, 0, 0, 0, 8, 0, 0, 0, 2, 2, 23, 0, 0, 1, 0, 7, 1, 0, 0, 0, 0, 0, 0, 0, 0, 0, 0, 0, 0, 0, 0, 0, 0, 7, 0, 3, 0, 0, 0, 1, 1, 0, 0, 0, 0, 0, 0, 0, 26, 2, 10, 0, 0, 0, 0, 0, 46, 3, 3, 0, 0, 0, 0, 0, 11, 0, 0, 0, 1, 0, 21, 0, 0, 0, 0, 0, 0, 0, 0, 0, 0, 0, 14, 0, 2, 0, 0, 0, 6, 0, 0, 2, 0, 16, 0, 0, 0, 0, 0, 0, 0, 0, 0, 0, 0, 0, 0, 0, 3, 0, 0, 0, 0, 0, 0, 0, 7, 0, 9, 0, 0, 0, 4, 28, 0, 0, 0, 2, 0, 5, 0, 0, 5, 1, 2, 0, 0, 20, 0, 0, 2, 1, 1, 27, 0, 0, 0, 0, 0, 0, 0, 0, 0, 7, 0, 0, 0, 0, 0, 0, 0, 0, 3, 0, 11, 0, 0, 0, 5, 1, 3, 0, 0, 0, 2, 0, 0, 1, 1, 0, 61, 0, 0, 25, 14, 0, 0, 0, 0, 20, 0, 0, 3, 0, 0, 0, 0, 1, 0, 0, 0, 0, 4, 5, 0, 0, 1, 30, 1, 0, 23, 0, 20, 0, 0, 0, 0, 0, 0, 6, 3, 8, 28, 0, 0, 0, 0, 0, 0, 0, 0, 0, 0, 0, 0, 0, 0, 53, 0, 12, 0, 0, 0, 0, 0, 0, 0, 0, 4, 16, 3, 0, 3, 0, 0, 29, 0, 0, 0, 0, 15, 21, 2, 0, 0, 2, 3, 0, 8, 0, 0, 0, 0, 0, 6, 0, 11, 0, 4, 0, 0, 1, 0, 0, 0, 57, 4, 0, 0, 0, 11, 0, 0, 0, 0, 16, 0, 2, 0, 0, 0, 0, 0, 0, 0, 0, 0, 0, 33, 4, 1
Fedex Delivers How the Worlds Leading Shipping Company Keeps Innovating and Outperforming the Competition by Madan Birla (z-lib.org), 0, 0, 0, 12, 410, 0, 0, 0, 0, 14, 2, 1, 0, 0, 0, 13, 0, 0, 0, 0, 0, 0, 0, 14, 4, 0, 0, 0, 1, 0, 0, 0, 1, 0, 0, 0, 0, 0, 19, 0, 63, 0, 0, 0, 0, 0, 0, 4, 0, 0, 0, 75, 0, 0, 0, 0, 0, 0, 0, 0, 3, 0, 0, 0, 1, 0, 0, 20, 0, 1, 0, 0, 0, 0, 0, 0, 0, 0, 20, 0, 0, 0, 0, 0, 0, 3, 0, 0, 0, 9, 0, 0, 1, 0, 0, 0, 0, 0, 1, 22, 0, 0, 0, 0, 0, 0, 0, 0, 0, 0, 0, 19, 0, 0, 0, 6, 0, 1, 9, 0, 0, 0, 0, 0, 0, 110, 0, 0, 0, 0, 1, 0, 0, 0, 0, 0, 0, 0, 0, 0, 0, 0, 0, 0, 0, 18, 85, 0, 0, 0, 1, 0, 0, 0, 7, 32, 5, 0, 15, 1, 0, 76, 0, 0, 0, 0, 0, 1, 0, 0, 0, 1, 0, 34, 0, 0, 0, 0, 15, 7, 0, 101, 0, 4, 0, 0, 0, 11, 0, 2, 0, 0, 0, 0, 6, 0, 0, 5, 60, 0, 0, 0, 0, 64, 0, 0, 74, 0, 0, 12, 23, 8, 0, 0, 4, 0, 0, 0, 0, 1, 0, 0, 0, 0, 0, 0, 0, 0, 0, 0, 0, 0, 0, 0, 0, 0, 5, 0, 0, 0, 0, 4, 1, 0, 1, 0, 0, 0, 2, 1, 55, 0, 0, 0, 7, 0, 9, 0, 0, 0, 0, 20, 2, 3, 0, 0, 19, 0, 0, 6, 25, 0, 1, 0, 9, 9, 0, 0, 0, 0, 1, 0, 0, 0, 5, 0, 0, 0, 0, 0, 0, 20, 1, 0, 0, 2, 0, 23, 1, 0, 1, 23, 0, 0, 0, 21, 81, 0, 0, 1, 54, 0, 0, 0, 1, 25, 0, 131, 0, 0, 9, 0, 0, 18, 0, 0, 0, 0, 25, 0, 0, 19, 0, 0, 0, 0, 0, 0, 0, 0, 1, 0, 0, 0, 0, 0, 19, 0, 0, 0, 0, 5, 1, 0, 212, 0, 0, 11, 0, 0, 19, 0, 0, 0, 0, 0, 0, 0, 2, 1, 0, 0, 1, 3, 0, 0, 5, 0, 0, 41, 0, 0, 3, 0, 0, 117, 0, 0, 3, 0, 0, 50, 0, 0, 0, 0, 0, 0, 0, 0, 0, 0, 0, 0, 0, 0, 0, 0, 0, 7, 179, 0, 0, 0, 7, 0, 0, 0, 0, 0, 0, 0, 0, 2, 0, 17, 0, 0, 309, 0, 0, 4, 0, 0, 0, 0, 2, 0, 4, 1, 0, 62, 0, 0, 114, 0, 0, 0, 0, 0, 0, 0, 0, 2, 0, 0, 56, 81, 0, 0, 0, 224, 0, 1, 1, 0, 6, 0, 0, 0, 0, 0, 0, 0, 0, 0, 0, 0, 0, 0, 0, 0, 0, 0, 0, 0, 1, 1, 0, 0, 0, 0, 0, 0, 0, 0, 0, 0, 29, 1, 0, 0, 0, 20, 0, 0, 0, 0, 0, 0, 0, 0, 6, 3, 31, 25, 0, 0, 0, 0, 0, 0, 5, 0, 0, 89, 0, 1, 0, 1, 50, 0, 0, 0, 0, 0, 1, 7, 0, 3, 5, 0, 0, 0, 0, 0, 2, 0, 0, 0, 0, 54, 0, 0, 0, 0, 34, 0, 0, 8, 3, 0, 0, 0, 0, 0, 0, 1, 0, 0, 32, 0, 0, 0, 0, 0, 51, 25, 0, 0, 0, 0, 0, 0, 1, 0, 0, 0, 0, 0, 0, 38, 4, 0, 0, 70, 0, 12, 0, 5, 0, 0, 1, 7, 0, 0, 0, 0, 0, 1, 7, 1, 2, 0, 2, 0, 0, 14, 0, 0, 0, 6, 0, 0, 27, 0, 0, 52, 1, 3, 0, 3, 0, 1, 0, 0, 13, 0, 0, 7, 0, 53, 0, 0, 1, 0, 70, 1, 0, 0, 2, 0, 0, 0, 0, 0, 0, 4, 0, 2, 0, 0, 188, 0, 0, 0, 0, 0, 0, 0, 0, 0, 33, 0, 1, 41, 0, 0, 0, 0, 0, 61, 0, 0, 10, 0, 0, 0, 36, 0, 0, 42, 0, 0, 6, 8, 21, 0, 0, 1, 244, 0, 0, 0, 0, 0, 113, 10, 0, 0, 0, 43, 0, 0, 23, 0, 16, 0, 0, 0, 0, 2, 0, 0, 0, 17, 0, 2, 0, 9, 0, 0, 27, 1, 0, 0, 0, 0, 0, 0, 0, 0, 0, 0, 0, 63, 0, 0, 0, 31, 0, 1, 16, 0, 0, 0, 0, 0, 0, 0, 6, 0, 0, 0, 26, 0, 0, 0, 11, 0, 0, 0, 0, 3, 0, 2, 5, 0, 0, 3, 22, 7, 0, 1, 0, 13, 3, 0, 100, 0, 0, 0, 0, 10, 0, 0, 27, 0, 0, 0, 0, 0, 0, 0, 0, 0, 0, 13, 0, 0, 0, 3, 0, 1, 0, 0, 0, 0, 5, 0, 0, 0, 4, 0, 0, 0, 0, 14, 1, 0, 24, 0, 2, 3, 0, 0, 1, 0, 0, 0, 0, 0, 0, 0, 1, 0, 0, 3, 23, 13, 2, 0, 0, 0, 0, 0, 2, 0, 0, 0, 0, 6, 0, 0, 0, 0, 1, 0, 1, 0, 0, 3, 0, 1, 0, 0, 0, 0, 0, 2, 0, 62, 18, 0, 0, 0, 2, 0, 5, 192, 6, 0, 0, 0, 0, 3, 0, 50, 1, 0, 0, 0, 56, 0, 0, 4, 0, 0, 0, 0, 0, 358, 0, 1, 0, 0, 0, 0, 1, 0, 0, 0, 0, 0, 0, 2, 0, 0, 0, 0, 0, 5, 0, 0, 12, 0, 0, 0, 0, 4, 0, 0, 67, 0, 0, 1, 0, 0, 0, 0, 1, 0, 0, 0, 39, 1, 0, 5, 0, 0, 5, 0, 0, 3, 0, 5, 0, 1, 0, 0, 0, 125, 0, 0, 0, 0, 0, 0, 11, 0, 0, 5, 0, 0, 0, 0, 93, 0, 0, 11, 0, 0, 17, 92, 0, 71, 0, 0, 0, 0, 2, 0, 0, 0, 1, 0, 0, 1, 18, 52, 0, 0, 0, 17, 0, 0, 0, 2, 71, 0, 0, 0, 0, 12, 0, 0, 0, 0, 0, 7, 0, 0, 0, 0, 3, 0, 0, 0, 54, 0, 47, 0, 0, 0, 0, 0, 0, 0, 0, 0, 0, 0, 133, 0, 0, 10, 0, 0, 0, 0, 0, 13, 0, 0, 0, 3, 2, 0, 0, 0, 0, 0, 16, 0, 0, 0, 26, 0, 4, 0, 0, 0, 0, 0, 0, 0, 0, 0, 2, 0, 0, 0, 0, 0, 13, 0, 10, 0, 0, 0, 39, 14, 0, 0, 11, 46, 0, 0, 0, 0, 0, 9, 0, 22, 0, 0, 0, 49, 1, 0, 0, 0, 0, 0, 0, 0, 47, 0, 0, 0, 0, 0, 38, 1, 7, 0, 58, 1, 0, 0, 0, 7, 0, 63, 1, 4, 0, 0, 0, 0, 0, 0, 0, 92, 0, 0, 0, 1, 6, 0, 0, 4, 0, 0, 0, 0, 0, 0, 0, 0, 0, 0, 0, 95, 32, 0, 0, 0, 0, 0, 0, 79, 0, 3, 0, 0, 0, 0, 0, 0, 0, 0, 2, 120, 0, 0, 5, 1, 0, 0, 1, 0, 0, 46, 0, 0, 9, 11, 0, 0, 0, 0, 0, 0, 0, 0, 0, 0, 0, 0, 0, 51, 2, 0, 10, 0, 2, 0, 0, 0, 0, 0, 0, 3, 0, 1, 0, 0, 0, 0, 3, 1, 0, 0, 10, 7, 0, 0, 1, 0, 0, 0, 0, 0, 2, 0, 0, 0, 43, 0, 0, 14, 49, 0, 0, 0, 0, 0, 0, 0, 15, 0, 0, 0, 0, 7, 0, 0, 0, 0, 0, 1, 0, 0, 0, 0, 0, 0, 1, 0, 0, 3, 0, 0, 0, 0, 0, 0, 252, 8, 0, 0, 13, 0, 0, 0, 1, 0, 1, 0, 0, 0, 1, 0, 0, 24, 0, 0, 49, 0, 0, 0, 0, 0, 38, 0, 0, 0, 0, 0, 0, 0, 24, 1, 0, 0, 25, 0, 0, 42, 4, 0, 0, 0, 0, 0, 0, 1, 0, 0, 1, 0, 0, 0, 0, 5, 0, 0, 0, 0, 0, 9, 0, 0, 1, 89, 3, 3, 0, 0, 7, 0, 0, 0, 69, 13, 0, 0, 0, 2, 0, 0, 0, 0, 0, 0, 0, 7, 0, 47, 0, 0, 0, 3, 0, 0, 0, 1, 1, 0, 0, 5, 0, 46, 0, 0, 0, 3, 45, 0, 0, 0, 0, 0, 0, 0, 0, 0, 6, 0, 0, 5, 0, 0, 7, 25, 45, 1, 0, 0, 1, 3, 0, 24, 0, 0, 0, 0, 0, 1, 0, 23, 7, 0, 0, 0, 0, 1, 0, 0, 64, 1, 2, 0, 0, 1, 0, 12, 0, 0, 0, 0, 0, 0, 0, 0, 0, 0, 19, 0, 0, 0, 0, 1, 1, 21, 0, 9, 0, 1, 0, 2, 0, 0, 0, 0, 0, 0, 0, 0, 9, 0, 24, 0, 0, 0, 0, 0, 232, 2, 1, 0, 0, 0, 0, 0, 0, 0, 0, 0, 0, 0, 15, 0, 0, 0, 0, 0, 0, 6, 0, 0, 71, 0, 1, 0, 3, 0, 0, 0, 0, 0, 0, 0, 0, 80, 0, 0, 0, 0, 0, 0, 2, 0, 0, 12, 3, 0, 0, 0, 0, 2, 0, 0, 0, 0, 0, 0, 0, 0, 0, 14, 0, 0, 0, 2, 0, 0, 0, 0, 1, 0, 0, 0, 0, 0, 9, 0, 0, 4, 0, 0, 17, 5, 134, 18, 0, 0, 0, 0, 22, 0, 0, 0, 0, 2, 1, 0, 0, 0, 0, 0, 0, 0, 1, 0, 3, 0, 0, 0, 5, 0, 1, 0, 0, 0, 0, 0, 0, 0, 0, 0, 9, 0, 0, 33, 9, 0, 0, 0, 0, 0, 1, 0, 2, 0, 0, 0, 0, 0, 0, 0, 0, 0, 4, 22, 0, 0, 0, 5, 0, 0, 42, 0, 12, 0, 0, 0, 0, 0, 0, 12, 0, 1, 19, 0, 0, 0, 0, 0, 7, 0, 1, 1, 0, 0, 0, 0, 0, 9, 0, 23, 0, 0, 0, 2, 0, 0, 0, 1, 3, 8, 0, 0, 28, 0, 0, 2, 0, 0, 0, 0, 17, 115, 0, 2, 0, 2, 1, 0, 0, 4, 0, 13, 0, 0, 9, 0, 4, 0, 3, 0, 0, 3, 0, 0, 0, 0, 8, 0, 0, 3, 3, 0, 0, 0, 0, 3, 0, 5, 0, 0, 0, 0, 0, 0, 0, 0, 0, 52, 18, 4, 0
For-God_-Country_-and-Coca-Cola-The-Definitive-History-of-the-Great-American-Soft-Drink-and-the-Comp, 0, 0, 0, 140, 138, 0, 0, 0, 0, 84, 1, 28, 9, 0, 0, 0, 0, 0, 0, 0, 0, 0, 0, 13, 0, 0, 0, 20, 17, 0, 0, 0, 2, 2, 0, 0, 0, 12, 81, 0, 23, 0, 239, 0, 0, 0, 0, 9, 0, 0, 0, 51, 0, 2, 0, 28, 0, 0, 0, 0, 152, 0, 0, 0, 12, 0, 0, 158, 1, 8, 0, 0, 0, 0, 3, 7, 0, 0, 36, 0, 0, 0, 0, 0, 0, 91, 0, 24, 0, 329, 0, 0, 42, 1, 0, 0, 0, 1, 3, 2, 3, 92, 0, 5, 0, 0, 1, 0, 9, 1, 0, 43, 0, 2, 0, 78, 0, 12, 2, 0, 1, 0, 1, 0, 26, 341, 0, 0, 0, 0, 13, 0, 0, 0, 0, 0, 1, 0, 0, 45, 0, 1, 0, 0, 1, 14, 88, 0, 5, 0, 0, 0, 13, 0, 55, 20, 4, 0, 91, 9, 4, 67, 0, 0, 3, 0, 30, 23, 88, 17, 0, 108, 0, 45, 6, 0, 18, 0, 20, 21, 0, 52, 0, 131, 0, 1, 0, 53, 0, 32, 0, 0, 6, 20, 22, 1, 0, 0, 23, 3, 0, 8, 0, 96, 0, 0, 24, 0, 35, 19, 20, 127, 53, 0, 25, 0, 1, 98, 0, 13, 0, 0, 0, 0, 45, 0, 0, 0, 11, 51, 2, 162, 46, 0, 0, 0, 83, 0, 0, 0, 0, 86, 40, 0, 7, 0, 0, 0, 2, 319, 42, 0, 0, 0, 143, 0, 84, 0, 0, 0, 1, 55, 11, 8, 0, 0, 8, 1, 0, 25, 14, 0, 80, 9, 22, 28, 0, 3, 2, 0, 138, 0, 0, 0, 13, 0, 0, 2, 2, 55, 0, 40, 1, 3, 1, 8, 0, 45, 4, 65, 5, 6, 1, 0, 0, 221, 57, 0, 0, 3, 39, 0, 0, 0, 0, 25, 0, 23, 0, 4, 9, 0, 0, 16, 0, 0, 0, 0, 60, 0, 0, 50, 0, 36, 7, 0, 0, 2, 0, 0, 13, 0, 0, 0, 0, 0, 46, 0, 0, 33, 2, 6, 10, 0, 82, 13, 4, 124, 0, 0, 28, 0, 15, 193, 0, 1, 20, 0, 34, 4, 0, 0, 0, 6, 0, 0, 32, 53, 2, 305, 0, 0, 26, 6, 0, 11, 4, 0, 14, 0, 14, 16, 0, 0, 0, 0, 0, 2, 1, 0, 0, 0, 0, 4, 0, 0, 0, 0, 0, 117, 10, 0, 0, 1, 33, 2, 1, 0, 0, 3, 0, 0, 7, 0, 0, 12, 0, 0, 47, 0, 0, 13, 0, 1, 8, 0, 0, 2, 145, 4, 1, 24, 0, 2, 184, 1, 1, 0, 1, 0, 0, 18, 19, 1, 23, 0, 129, 52, 2, 0, 3, 477, 0, 12, 20, 0, 51, 0, 0, 0, 0, 0, 0, 0, 26, 0, 0, 0, 1, 64, 0, 13, 12, 0, 7, 0, 89, 0, 8, 0, 0, 0, 101, 2, 0, 0, 11, 11, 41, 8, 0, 0, 0, 41, 0, 0, 0, 0, 0, 0, 0, 1, 12, 0, 66, 62, 0, 20, 0, 3, 0, 0, 30, 3, 0, 54, 0, 6, 0, 2, 8, 0, 0, 4, 0, 6, 20, 35, 0, 0, 17, 35, 0, 7, 8, 0, 1, 1, 0, 3, 0, 1, 12, 0, 0, 0, 60, 0, 0, 9, 7, 0, 0, 36, 0, 0, 0, 119, 0, 0, 37, 0, 0, 418, 0, 0, 6, 102, 510, 0, 31, 1, 0, 0, 24, 5, 0, 0, 16, 0, 0, 0, 145, 0, 0, 7, 0, 96, 0, 98, 0, 0, 1, 24, 0, 0, 0, 0, 16, 22, 162, 2920, 52, 0, 47, 0, 0, 12, 29, 0, 3, 4, 1, 0, 106, 4, 0, 37, 6, 25, 0, 60, 622, 23, 0, 0, 159, 0, 0, 4, 0, 32, 0, 0, 91, 0, 90, 9, 0, 0, 20, 0, 121, 0, 2, 5, 1, 58, 0, 0, 0, 0, 33, 0, 2, 0, 9, 0, 13, 0, 9, 0, 0, 0, 11, 22, 5, 0, 0, 0, 2, 95, 0, 0, 80, 4, 3, 0, 30, 4, 0, 25, 0, 0, 46, 5, 0, 0, 0, 0, 62, 16, 0, 0, 0, 0, 43, 35, 0, 0, 0, 156, 0, 0, 99, 0, 23, 0, 0, 0, 0, 9, 0, 0, 0, 59, 0, 16, 1, 20, 0, 0, 15, 282, 0, 0, 0, 0, 1, 0, 0, 0, 10, 0, 0, 21, 12, 0, 192, 60, 0, 7, 52, 0, 0, 0, 7, 11, 0, 0, 135, 1, 4, 0, 6, 0, 0, 0, 18, 0, 2, 0, 0, 31, 3, 9, 59, 0, 0, 15, 4, 45, 0, 21, 12, 102, 42, 0, 44, 52, 0, 1, 0, 19, 0, 4, 87, 0, 0, 0, 0, 0, 0, 0, 0, 0, 1, 31, 33, 2, 0, 25, 0, 24, 3, 0, 0, 0, 27, 0, 0, 0, 57, 0, 33, 0, 0, 12, 12, 133, 124, 0, 21, 19, 2, 1, 5, 1, 0, 0, 0, 0, 2, 0, 7, 0, 13, 19, 33, 46, 202, 4, 3, 0, 0, 0, 39, 1, 0, 0, 0, 6, 0, 0, 0, 1, 8, 0, 10, 0, 0, 27, 9, 2074, 0, 0, 46, 19, 3, 13, 1, 32, 10, 0, 0, 0, 6, 0, 3, 232, 42, 0, 53, 7, 0, 65, 0, 25, 0, 0, 32, 28, 25, 2, 1, 4, 0, 8, 0, 4, 0, 0, 0, 92, 0, 0, 0, 0, 15, 0, 0, 0, 0, 1, 2, 16, 0, 1, 0, 3, 0, 0, 11, 11, 97, 0, 0, 140, 1, 7, 0, 5, 54, 0, 0, 4, 0, 0, 0, 0, 9, 0, 0, 0, 2, 0, 0, 86, 2, 0, 128, 1, 0, 26, 0, 65, 14, 8, 1, 0, 0, 21, 0, 0, 63, 0, 0, 0, 42, 0, 0, 0, 27, 0, 0, 1, 114, 0, 0, 123, 2, 0, 15, 173, 0, 8, 36, 0, 0, 1, 0, 0, 0, 0, 0, 2, 4, 144, 59, 11, 0, 0, 0, 38, 10, 15, 0, 268, 13, 2, 53, 12, 0, 93, 0, 0, 1, 2, 569, 53, 78, 0, 0, 1, 8, 1, 0, 0, 15, 0, 78, 0, 0, 0, 9, 0, 0, 0, 0, 0, 24, 0, 49, 3, 0, 12, 6, 4, 0, 3, 0, 2, 0, 19, 16, 135, 3, 2, 1, 0, 0, 0, 135, 54, 0, 0, 86, 0, 31, 0, 0, 0, 20, 0, 0, 0, 0, 0, 39, 0, 0, 0, 0, 0, 45, 0, 8, 0, 22, 14, 272, 125, 0, 1, 74, 22, 0, 0, 0, 2, 0, 50, 0, 117, 1, 0, 0, 9, 77, 0, 0, 0, 0, 0, 11, 1, 74, 0, 1, 2, 0, 7, 17, 9, 121, 0, 170, 8, 0, 0, 0, 5, 0, 88, 14, 31, 1, 0, 0, 0, 0, 0, 5, 64, 0, 71, 6, 0, 45, 0, 1, 10, 0, 0, 0, 10, 0, 0, 0, 5, 0, 0, 10, 14, 0, 0, 2, 0, 0, 0, 3, 43, 0, 2, 8, 0, 0, 0, 0, 0, 0, 15, 1, 18, 0, 0, 43, 7, 0, 0, 7, 0, 19, 15, 0, 17, 94, 80, 4, 0, 0, 0, 0, 0, 0, 3, 1, 0, 0, 0, 1, 107, 10, 0, 84, 10, 27, 17, 2, 0, 0, 0, 39, 41, 0, 49, 784, 0, 0, 0, 24, 26, 0, 0, 42, 6, 0, 0, 3, 6, 0, 4, 0, 0, 16, 0, 0, 0, 0, 10, 0, 16, 303, 0, 0, 0, 0, 0, 2, 0, 68, 0, 0, 0, 19, 11, 0, 0, 0, 0, 4, 7, 0, 1, 0, 2, 22, 0, 0, 0, 177, 1, 0, 0, 16, 13, 0, 0, 1368, 7, 6, 0, 91, 0, 0, 0, 4, 7, 0, 6, 0, 0, 23, 3, 0, 162, 6, 0, 1, 0, 14, 0, 41, 0, 136, 1, 0, 1, 0, 8, 0, 0, 99, 0, 0, 0, 133, 12, 48, 65, 11, 0, 0, 0, 0, 0, 6, 1, 0, 39, 0, 0, 0, 0, 0, 0, 157, 0, 0, 0, 0, 31, 0, 0, 7, 121, 137, 112, 1, 1, 25, 46, 0, 0, 67, 5, 0, 0, 0, 11, 0, 0, 0, 0, 0, 16, 0, 24, 0, 4, 8, 0, 1, 40, 0, 0, 0, 1110, 0, 47, 0, 96, 0, 77, 0, 11, 0, 26, 107, 4, 0, 0, 0, 2, 0, 2, 0, 91, 34, 0, 0, 43, 10, 0, 48, 43, 3, 79, 0, 0, 12, 24, 3, 122, 0, 7, 0, 33, 0, 12, 0, 10, 2, 0, 0, 0, 8, 5, 0, 0, 33, 17, 36, 0, 0, 94, 0, 79, 0, 0, 0, 4, 8, 0, 0, 0, 0, 23, 3, 0, 11, 0, 67, 4, 0, 73, 0, 44, 0, 1, 4, 35, 60, 0, 0, 25, 0, 0, 0, 3, 95, 3, 22, 0, 0, 0, 14, 0, 394, 211, 7, 1, 0, 0, 0, 0, 3, 0, 0, 1, 10, 30, 2, 4, 2, 0, 32, 0, 0, 2, 0, 0, 22, 0, 7, 0, 21, 0, 0, 0, 2, 0, 1, 0, 0, 26, 4, 0, 0, 3, 0, 0, 2, 0, 0, 0, 32, 0, 0, 0, 17, 20, 0, 4, 0, 1, 0, 0, 3, 0, 2, 0, 1, 0, 0, 91, 2, 0, 0, 0, 0, 53, 0, 10, 3, 27, 82, 0, 0, 136, 0, 0, 0, 61, 34, 52, 0, 0, 4, 29, 0, 0, 22, 0, 0, 46, 82, 0, 0, 0, 0, 0, 1, 0, 44, 0, 0, 0, 27, 0, 21, 3, 6, 0, 4, 0, 30, 17, 0, 22, 9, 4, 173, 0, 0, 73, 109, 0, 0, 0, 0, 0, 0, 13, 33, 106, 0, 0, 0, 5, 0, 2, 0, 252, 73, 79, 0, 0, 2, 53, 0, 0, 63, 1, 15, 0, 0, 0, 2, 0, 1, 65, 0, 37, 53, 0, 0, 0, 1, 3, 2, 0, 7, 2871, 0, 0, 3, 0, 113, 78, 1, 57, 0, 0, 0, 13, 28, 0, 0, 0, 6, 159, 1, 105, 20, 5, 0, 43, 0, 0, 41, 0, 48, 140, 0, 17, 7, 3, 12, 0, 11, 7, 0, 4, 0, 0, 3, 1, 39, 7, 13, 0, 0, 2, 1, 0, 0, 0, 38, 0, 0, 13, 438, 0, 0, 1, 4, 60, 1, 45, 0, 0, 0, 0, 1, 0, 0, 3, 4, 28, 128, 54, 12
German Industry and Global Enterprise BASF The History of a Company by Werner Abelshauser- Wolfgang von Hippel- Jeffrey Allan Johnson- Raymond G. Stokes (z-lib.org), 0, 0, 0, 56, 144, 0, 0, 0, 0, 138, 0, 5, 1, 0, 0, 12, 10, 0, 0, 0, 0, 20, 0, 35, 10, 0, 0, 48, 0, 0, 0, 0, 6, 0, 0, 0, 0, 33, 131, 0, 12, 0, 414, 0, 0, 0, 0, 74, 0, 0, 0, 265, 0, 0, 0, 0, 0, 0, 0, 1, 61, 5, 0, 0, 69, 0, 0, 126, 0, 4, 3, 3, 22, 18, 2, 0, 0, 0, 180, 0, 0, 0, 0, 0, 0, 14, 0, 6, 0, 118, 1, 3, 14, 3, 0, 0, 0, 1, 1, 0, 0, 0, 0, 0, 0, 0, 0, 22, 14, 0, 0, 72, 0, 2, 0, 75, 0, 0, 2, 0, 5, 0, 0, 0, 813, 76, 0, 0, 0, 0, 0, 0, 0, 0, 0, 0, 0, 0, 0, 18, 0, 0, 0, 0, 0, 144, 192, 0, 0, 0, 3, 1, 17, 0, 3, 155, 8, 0, 161, 7, 0, 31, 0, 0, 16, 0, 37, 10, 69, 15, 1, 0, 0, 28, 9, 0, 3, 0, 88, 114, 0, 217, 0, 186, 0, 0, 0, 16, 0, 1, 0, 1, 119, 158, 34, 1, 0, 9, 38, 0, 0, 8, 0, 228, 0, 0, 11, 0, 7, 66, 70, 168, 0, 0, 0, 212, 0, 0, 0, 5, 0, 0, 0, 0, 40, 0, 0, 0, 0, 0, 0, 1, 0, 0, 0, 0, 24, 0, 0, 0, 1, 43, 14, 0, 0, 0, 0, 0, 0, 0, 11, 0, 0, 0, 139, 0, 134, 14, 0, 0, 0, 48, 0, 0, 0, 0, 4, 0, 0, 37, 35, 0, 49, 23, 23, 1, 0, 0, 0, 0, 18, 0, 0, 0, 0, 0, 0, 0, 17, 20, 3, 57, 2, 0, 0, 47, 0, 117, 2, 64, 0, 111, 0, 0, 0, 63, 114, 0, 0, 0, 86, 0, 0, 0, 0, 43, 0, 3, 0, 4, 25, 0, 0, 72, 0, 0, 0, 132, 19, 0, 0, 26, 0, 0, 7, 0, 0, 366, 0, 0, 0, 0, 0, 0, 0, 0, 187, 6, 0, 44, 0, 82, 28, 0, 116, 5, 0, 1041, 0, 0, 17, 0, 5, 0, 0, 0, 16, 0, 91, 0, 0, 0, 0, 2, 0, 0, 168, 0, 2, 495, 0, 0, 0, 0, 183, 112, 0, 0, 19, 0, 10, 60, 0, 0, 3, 0, 33, 0, 0, 0, 0, 0, 0, 0, 0, 0, 0, 0, 0, 22, 41, 0, 0, 0, 29, 0, 0, 0, 0, 0, 0, 0, 1, 0, 0, 1, 0, 0, 78, 0, 20, 0, 0, 1, 0, 0, 0, 0, 9, 4, 0, 26, 0, 0, 26, 0, 0, 0, 0, 0, 0, 0, 2, 0, 0, 0, 209, 39, 1, 0, 0, 459, 0, 0, 11, 0, 29, 0, 0, 0, 0, 0, 267, 0, 0, 0, 0, 161, 0, 210, 0, 0, 7, 0, 0, 0, 0, 0, 0, 0, 0, 0, 0, 2, 0, 0, 5, 25, 47, 5, 0, 0, 0, 10, 1, 0, 0, 0, 0, 0, 0, 0, 1, 0, 159, 14, 0, 7, 0, 83, 0, 0, 25, 0, 0, 94, 0, 0, 0, 8, 121, 0, 0, 0, 0, 0, 3, 100, 0, 0, 0, 59, 0, 3, 1, 204, 0, 0, 0, 0, 0, 10, 91, 0, 0, 0, 137, 3, 46, 25, 0, 0, 0, 0, 0, 0, 0, 15, 0, 0, 33, 0, 0, 2, 0, 0, 1, 119, 0, 0, 7, 0, 0, 0, 0, 6, 0, 0, 0, 0, 0, 60, 7, 0, 0, 12, 0, 70, 0, 13, 0, 0, 2, 88, 0, 0, 0, 0, 16, 41, 41, 0, 7, 0, 16, 0, 0, 99, 22, 0, 0, 89, 4, 0, 40, 9, 0, 60, 0, 14, 0, 15, 0, 4, 0, 0, 242, 0, 0, 0, 1, 922, 0, 0, 120, 0, 125, 3, 0, 0, 3, 0, 13, 0, 0, 1, 0, 3, 0, 18, 1, 0, 404, 0, 6, 0, 19, 0, 14, 0, 1, 0, 0, 0, 69, 112, 0, 0, 0, 0, 0, 33, 5, 0, 27, 13, 0, 0, 1, 21, 0, 67, 0, 0, 14, 22, 31, 0, 0, 7, 104, 5, 0, 0, 0, 0, 34, 16, 0, 0, 0, 19, 0, 0, 84, 0, 80, 0, 0, 0, 3, 0, 0, 0, 0, 100, 0, 2, 0, 63, 0, 0, 63, 775, 0, 0, 0, 0, 0, 0, 0, 0, 0, 0, 0, 21, 0, 0, 0, 95, 0, 2, 27, 0, 0, 0, 1, 0, 0, 0, 17, 0, 0, 0, 0, 0, 0, 0, 67, 0, 1, 0, 0, 18, 1, 5, 151, 0, 0, 22, 55, 15, 0, 23, 0, 173, 12, 0, 232, 71, 112, 0, 4, 0, 0, 0, 267, 0, 0, 0, 0, 0, 0, 50, 0, 0, 0, 49, 0, 0, 0, 5, 0, 2, 490, 0, 0, 0, 10, 0, 0, 0, 11, 0, 462, 0, 0, 0, 60, 0, 2, 0, 66, 72, 0, 1, 0, 0, 0, 27, 3, 0, 1, 0, 2, 0, 0, 59, 62, 55, 67, 0, 23, 0, 112, 0, 6, 0, 0, 0, 0, 63, 0, 0, 0, 0, 10, 165, 0, 308, 0, 24, 6, 18, 0, 0, 1, 0, 56, 4, 0, 69, 0, 0, 0, 1, 7, 0, 1, 64, 72, 0, 149, 5, 0, 14, 0, 31, 0, 0, 5, 11, 62, 0, 0, 13, 0, 0, 0, 0, 0, 0, 0, 156, 0, 0, 0, 0, 0, 0, 0, 0, 0, 0, 4, 73, 0, 1, 0, 3, 0, 0, 18, 0, 121, 0, 0, 2, 0, 0, 0, 1, 95, 0, 0, 0, 0, 0, 0, 0, 2, 0, 0, 0, 2, 61, 0, 11, 1, 0, 53, 7, 0, 7, 0, 9, 0, 0, 1, 0, 0, 2, 13, 0, 170, 0, 0, 0, 268, 0, 0, 0, 143, 0, 0, 9, 68, 0, 0, 106, 0, 0, 5, 361, 138, 284, 0, 0, 0, 0, 0, 0, 14, 0, 0, 8, 0, 21, 105, 20, 1, 0, 0, 205, 0, 3, 0, 7, 12, 0, 14, 2, 0, 25, 0, 0, 0, 1, 0, 83, 178, 1, 0, 0, 4, 0, 0, 0, 12, 0, 112, 0, 0, 0, 0, 4, 0, 1, 0, 0, 4, 0, 70, 0, 0, 4, 0, 0, 0, 8, 0, 0, 0, 16, 7, 91, 11, 0, 1, 0, 0, 0, 28, 5, 0, 0, 265, 2, 5, 0, 0, 0, 38, 0, 0, 0, 0, 0, 23, 0, 0, 0, 0, 0, 5, 0, 85, 0, 62, 3, 543, 37, 0, 2, 72, 42, 2, 0, 0, 0, 0, 59, 0, 0, 0, 0, 0, 28, 76, 0, 0, 1, 0, 0, 0, 0, 95, 0, 1, 1, 0, 18, 25, 7, 35, 59, 16, 3, 0, 0, 0, 7, 0, 8, 4, 91, 0, 0, 0, 0, 2, 0, 3, 179, 0, 0, 1, 34, 210, 0, 32, 5, 0, 0, 0, 0, 0, 6, 0, 0, 0, 0, 18, 44, 0, 0, 0, 0, 0, 0, 3, 214, 0, 21, 0, 0, 0, 0, 0, 0, 0, 0, 0, 85, 2, 0, 2, 191, 0, 0, 2, 0, 0, 37, 11, 77, 7, 70, 3, 0, 0, 0, 0, 0, 0, 48, 9, 0, 0, 0, 0, 166, 28, 0, 69, 5, 17, 0, 3, 0, 0, 0, 8, 14, 0, 18, 4, 0, 0, 0, 16, 4, 0, 0, 24, 30, 0, 0, 0, 22, 0, 0, 0, 161, 1, 16, 0, 175, 3, 2, 1, 48, 501, 0, 0, 0, 0, 0, 0, 0, 6, 0, 0, 0, 1, 5, 0, 0, 205, 0, 0, 4, 0, 0, 0, 0, 156, 0, 0, 0, 0, 0, 0, 0, 3, 6, 0, 0, 726, 26, 0, 0, 126, 0, 0, 0, 0, 8, 0, 0, 0, 0, 123, 0, 0, 11, 3, 0, 0, 0, 0, 0, 18, 0, 20, 0, 0, 0, 0, 0, 0, 0, 184, 1, 0, 0, 120, 0, 8, 129, 33, 0, 0, 214, 0, 0, 1, 1, 0, 1, 2, 0, 0, 1, 0, 0, 1, 0, 3, 0, 0, 55, 0, 0, 28, 505, 19, 1, 0, 0, 22, 6, 133, 0, 91, 13, 0, 0, 0, 16, 0, 0, 0, 0, 0, 2, 0, 112, 0, 21, 63, 0, 12, 166, 1, 0, 0, 1, 3, 65, 0, 6, 0, 42, 0, 5, 13, 45, 230, 0, 0, 0, 0, 0, 0, 0, 0, 537, 251, 0, 1, 8, 0, 0, 121, 115, 6, 7, 0, 0, 5, 173, 0, 71, 0, 1, 0, 27, 0, 3, 0, 48, 0, 0, 0, 0, 4, 0, 0, 114, 56, 154, 0, 0, 0, 43, 0, 151, 0, 25, 0, 0, 2, 0, 0, 0, 0, 7, 0, 0, 1, 0, 0, 0, 0, 34, 0, 11, 0, 9, 0, 50, 5, 0, 0, 2, 0, 0, 0, 0, 0, 45, 12, 0, 0, 0, 2, 0, 358, 41, 14, 149, 1, 0, 0, 0, 29, 0, 1, 3, 26, 0, 68, 0, 3, 0, 1, 0, 0, 0, 0, 0, 61, 3, 0, 0, 3, 2, 0, 0, 1, 2, 0, 3, 0, 10, 0, 0, 0, 0, 0, 0, 0, 0, 0, 0, 72, 0, 0, 2, 2, 38, 3950, 1, 0, 11, 0, 1, 0, 0, 0, 12, 1, 0, 0, 24, 0, 0, 0, 0, 0, 1, 11, 21, 0, 70, 34, 0, 0, 21, 0, 0, 0, 120, 138, 124, 0, 1, 3, 5, 5, 0, 8, 0, 0, 76, 9, 0, 0, 0, 0, 0, 0, 0, 37, 0, 0, 0, 0, 0, 15, 8, 4, 1, 0, 0, 6, 1, 0, 20, 2, 25, 9, 0, 0, 248, 113, 0, 7, 0, 0, 0, 21, 17, 14, 1, 0, 0, 0, 4, 0, 0, 0, 0, 86, 114, 0, 0, 0, 13, 0, 0, 116, 0, 0, 2, 0, 0, 0, 0, 0, 263, 37, 8, 50, 1, 0, 0, 2, 3, 27, 0, 33, 0, 0, 2, 0, 0, 0, 15, 7, 48, 0, 0, 0, 24, 0, 0, 0, 0, 67, 4, 0, 0, 0, 76, 0, 34, 0, 0, 21, 0, 171, 185, 0, 22, 0, 27, 0, 0, 6, 16, 0, 416, 0, 0, 0, 0, 58, 0, 7, 0, 5, 40, 0, 0, 0, 0, 40, 0, 0, 5, 145, 0, 0, 0, 0, 31, 0, 188, 177, 2, 0, 0, 0, 820, 0, 13, 0, 6, 126, 50, 0
Hard-Drive-Bill-Gates-and-the-Making-of-the-Microsoft-Empire-_wallace_-Erickson-Wallace_-James_-_z-l, 0, 0, 0, 26, 113, 0, 0, 0, 0, 53, 0, 57, 2, 0, 0, 0, 4, 0, 0, 1, 0, 0, 0, 13, 0, 0, 64, 0, 5, 0, 0, 0, 0, 0, 0, 0, 0, 0, 44, 63, 4, 0, 14, 0, 0, 67, 0, 0, 0, 0, 0, 37, 0, 0, 0, 0, 0, 0, 0, 0, 89, 0, 0, 0, 7, 0, 0, 15, 0, 1, 0, 0, 0, 0, 24, 10, 0, 0, 15, 0, 0, 0, 0, 0, 0, 103, 0, 0, 0, 149, 2, 0, 91, 0, 0, 0, 9, 0, 6, 21, 0, 0, 0, 0, 0, 0, 0, 0, 0, 45, 0, 21, 0, 0, 0, 30, 0, 12, 0, 0, 0, 0, 0, 0, 6, 274, 0, 0, 0, 1, 85, 0, 0, 0, 0, 0, 0, 0, 0, 8, 0, 0, 0, 0, 0, 6, 64, 0, 0, 0, 0, 2, 0, 0, 21, 41, 11, 0, 107, 0, 12, 43, 0, 0, 8, 0, 8, 1, 4, 1, 0, 0, 0, 22, 0, 0, 4, 0, 43, 41, 0, 24, 0, 32, 0, 0, 0, 19, 0, 28, 37, 0, 5, 3, 16, 3, 19, 503, 10, 0, 2, 1, 0, 38, 0, 0, 9, 0, 1, 4, 9, 47, 13, 0, 5, 0, 0, 0, 0, 17, 0, 0, 0, 0, 10, 0, 0, 0, 2, 0, 0, 0, 0, 0, 0, 0, 39, 0, 69, 0, 0, 6, 24, 0, 4, 0, 0, 0, 5, 0, 51, 0, 0, 0, 108, 0, 47, 0, 0, 0, 0, 6, 43, 0, 0, 0, 3, 2, 0, 19, 1, 0, 9, 3, 22, 34, 10, 0, 0, 0, 9, 0, 0, 0, 297, 0, 0, 0, 0, 11, 0, 8, 23, 0, 0, 4, 0, 35, 1, 22, 0, 73, 0, 0, 0, 37, 27, 0, 0, 89, 37, 0, 0, 0, 8, 219, 0, 19, 0, 3, 13, 0, 0, 12, 0, 0, 0, 0, 42, 0, 0, 14, 0, 7, 0, 0, 0, 0, 0, 0, 1, 0, 0, 0, 0, 0, 40, 1, 0, 3, 0, 5, 0, 0, 161, 0, 0, 61, 0, 0, 5, 24, 0, 1, 0, 0, 16, 0, 26, 4, 0, 0, 18, 95, 0, 0, 0, 17, 1, 91, 0, 0, 12, 0, 0, 4, 1, 0, 6, 0, 13, 10, 0, 0, 0, 0, 0, 1, 0, 0, 0, 0, 0, 24, 0, 0, 0, 0, 0, 50, 6, 0, 0, 0, 9, 0, 0, 0, 118, 0, 1, 0, 4, 5, 0, 23, 82, 0, 45, 0, 0, 98, 0, 0, 0, 0, 29, 0, 125, 2, 0, 28, 0, 0, 50, 0, 3, 0, 0, 0, 0, 1, 0, 0, 91, 4, 39, 10, 0, 0, 0, 516, 0, 1, 7, 0, 21, 0, 0, 0, 0, 0, 0, 0, 0, 0, 0, 0, 1, 6, 0, 0, 0, 0, 1, 0, 33, 0, 33, 0, 0, 0, 0, 0, 0, 0, 8, 3, 17, 4, 0, 0, 0, 23, 0, 0, 0, 0, 0, 0, 0, 2, 3, 1, 31, 165, 0, 31, 0, 0, 0, 0, 13, 1, 0, 18, 0, 0, 0, 2, 10, 3, 0, 0, 0, 0, 0, 12, 0, 0, 22, 0, 0, 4, 1, 0, 0, 0, 0, 2, 0, 2, 0, 0, 0, 0, 47, 0, 0, 0, 0, 0, 0, 0, 0, 0, 0, 11, 0, 37, 154, 0, 0, 10, 0, 0, 5, 56, 0, 1, 1, 0, 48, 0, 19, 11, 0, 0, 0, 0, 0, 1, 11, 0, 0, 11, 0, 18, 0, 37, 0, 0, 0, 21, 0, 0, 0, 0, 1, 7, 15, 1, 41, 92, 5, 6, 0, 15, 1, 0, 0, 9, 0, 0, 97, 0, 0, 33, 1, 23, 0, 30, 0, 18, 0, 0, 55, 0, 0, 8, 0, 30, 0, 0, 0, 0, 51, 1, 0, 0, 0, 0, 28, 0, 183, 0, 0, 49, 0, 0, 0, 0, 13, 75, 0, 0, 1, 0, 1, 0, 0, 0, 1, 0, 0, 31, 12, 0, 0, 0, 24, 138, 0, 0, 76, 2, 0, 0, 39, 0, 0, 68, 0, 0, 0, 5, 0, 0, 0, 0, 82, 2, 0, 0, 0, 0, 95, 10, 0, 0, 0, 75, 0, 0, 16, 0, 5, 0, 0, 0, 0, 0, 0, 0, 0, 23, 0, 1, 0, 15, 0, 0, 13, 2, 0, 0, 0, 0, 0, 0, 0, 0, 0, 0, 0, 5, 1, 0, 0, 221, 0, 1, 46, 0, 0, 0, 0, 3, 0, 0, 127, 0, 0, 0, 0, 0, 0, 0, 8, 0, 2, 0, 0, 20, 7, 1, 74, 0, 27, 11, 55, 8, 0, 11, 0, 31, 1, 0, 42, 2, 0, 42, 0, 38, 0, 52, 263, 0, 149, 0, 0, 0, 0, 0, 0, 0, 0, 25, 0, 0, 0, 16, 0, 1, 0, 0, 0, 0, 33, 0, 0, 0, 22, 0, 0, 0, 0, 7, 15, 0, 19, 0, 7, 5, 0, 0, 2, 0, 0, 0, 0, 0, 0, 0, 1, 0, 234, 18, 27, 74, 16, 0, 0, 0, 0, 0, 73, 0, 0, 0, 0, 6, 0, 0, 0, 0, 2, 0, 0, 0, 0, 5, 0, 6, 0, 0, 9, 24, 0, 3, 1, 11, 21, 0, 0, 1, 1897, 29, 4, 280, 57, 30, 0, 0, 0, 18, 0, 17, 1, 0, 0, 15, 15, 0, 0, 7, 0, 0, 6, 56, 0, 0, 0, 20, 0, 0, 0, 0, 2, 0, 0, 0, 0, 0, 1, 4, 0, 0, 0, 2, 0, 0, 4, 0, 41, 0, 0, 2, 2, 0, 0, 1, 17, 0, 0, 1, 19, 0, 0, 0, 13, 0, 0, 2, 6, 0, 0, 65, 1, 0, 8, 2, 0, 11, 0, 23, 0, 0, 0, 0, 0, 17, 0, 0, 3, 0, 0, 0, 11, 0, 0, 0, 105, 0, 1, 0, 42, 0, 0, 73, 0, 0, 3, 88, 0, 115, 1, 0, 0, 0, 1, 0, 0, 0, 5, 0, 1, 10, 8, 1, 0, 1, 0, 79, 18, 2, 0, 3, 32, 0, 0, 0, 0, 67, 0, 0, 0, 5, 0, 98, 2, 10, 0, 5, 1, 0, 0, 0, 5, 0, 28, 0, 0, 0, 1, 0, 0, 0, 0, 0, 6, 0, 16, 0, 0, 7, 0, 0, 0, 6, 0, 0, 0, 0, 3, 18, 0, 1, 0, 0, 0, 0, 53, 2, 0, 0, 5, 0, 47, 0, 0, 0, 1, 0, 0, 0, 0, 23, 22, 0, 0, 0, 0, 0, 20, 0, 253, 0, 0, 1, 193, 68, 0, 0, 30, 45, 1, 0, 0, 0, 0, 19, 0, 122, 0, 0, 0, 25, 24, 0, 0, 0, 0, 0, 0, 0, 63, 0, 0, 1, 0, 1, 24, 0, 170, 0, 104, 75, 0, 0, 0, 16, 0, 30, 15, 11, 0, 0, 0, 0, 0, 0, 5, 36, 0, 0, 11, 0, 23, 0, 0, 1, 0, 12, 0, 0, 0, 0, 0, 0, 0, 0, 11, 18, 0, 0, 0, 0, 0, 0, 0, 54, 0, 4, 0, 0, 0, 0, 0, 0, 0, 2, 0, 106, 0, 0, 24, 0, 0, 0, 16, 1, 0, 12, 0, 5, 18, 140, 5, 0, 0, 0, 0, 0, 0, 0, 1, 0, 0, 0, 43, 29, 4, 0, 81, 3, 4, 0, 0, 0, 0, 0, 7, 30, 0, 22, 5, 0, 0, 0, 28, 1, 0, 0, 50, 0, 0, 0, 1, 0, 0, 1, 0, 0, 2, 0, 0, 0, 5, 4, 2, 19, 247, 0, 0, 0, 0, 0, 1, 0, 61, 0, 0, 0, 12, 27, 0, 0, 0, 0, 0, 0, 0, 0, 0, 0, 3, 2, 0, 0, 0, 0, 0, 0, 19, 0, 0, 0, 653, 36, 0, 0, 20, 0, 0, 0, 0, 1, 10, 0, 103, 0, 23, 0, 0, 190, 3, 0, 0, 0, 4, 0, 0, 0, 47, 0, 0, 0, 0, 0, 0, 0, 38, 1, 0, 0, 30, 7, 29, 116, 10, 0, 0, 0, 0, 1, 0, 3, 0, 319, 30, 0, 0, 0, 0, 1, 0, 0, 0, 0, 0, 0, 0, 0, 13, 105, 41, 24, 9, 0, 10, 8, 0, 0, 29, 13, 0, 0, 0, 5, 0, 0, 0, 0, 55, 5, 0, 6, 0, 9, 0, 0, 0, 3, 0, 0, 0, 8, 0, 8, 0, 42, 0, 25, 0, 0, 0, 12, 90, 0, 0, 0, 0, 0, 0, 0, 0, 0, 22, 0, 1, 12, 0, 29, 30, 2, 7, 43, 0, 0, 2, 11, 0, 112, 0, 0, 0, 0, 0, 2, 0, 11, 1, 0, 0, 0, 37, 3, 0, 0, 40, 3, 74, 0, 0, 32, 0, 32, 0, 0, 0, 0, 2, 0, 0, 0, 0, 0, 9, 1, 2, 0, 0, 0, 0, 1, 13, 29, 0, 0, 2, 1, 4, 0, 0, 9, 0, 0, 1, 0, 29, 3, 33, 0, 1, 3, 1, 0, 243, 22, 0, 0, 0, 0, 0, 0, 5, 0, 0, 0, 0, 0, 18, 0, 0, 0, 9, 0, 0, 2, 0, 0, 6, 0, 3, 0, 14, 0, 0, 0, 2, 1, 0, 1, 0, 32, 1, 0, 0, 0, 0, 0, 0, 0, 0, 0, 4, 0, 0, 0, 6, 18, 0, 0, 0, 0, 0, 0, 0, 0, 14, 0, 0, 0, 1, 9, 0, 0, 0, 6, 0, 1, 0, 0, 0, 4, 1, 0, 0, 117, 0, 0, 4, 23, 7, 50, 0, 0, 0, 1, 0, 0, 2, 63, 0, 6, 3, 0, 0, 0, 0, 0, 0, 0, 13, 0, 413, 0, 0, 0, 48, 0, 9, 0, 0, 0, 7, 2, 0, 4, 0, 0, 111, 43, 0, 22, 52, 0, 0, 11, 0, 0, 0, 1, 10, 3, 0, 0, 1, 0, 0, 0, 1, 0, 42, 36, 0, 0, 0, 9, 0, 0, 77, 0, 42, 0, 0, 0, 0, 0, 0, 36, 0, 51, 108, 0, 0, 0, 0, 0, 3, 0, 0, 1, 0, 0, 0, 0, 1, 39, 0, 32, 0, 0, 0, 2, 0, 0, 0, 198, 161, 18, 0, 0, 7, 0, 0, 11, 0, 2, 1, 0, 186, 84, 0, 4, 0, 5, 6, 0, 1, 0, 0, 0, 0, 0, 2, 1, 44, 0, 16, 0, 0, 1, 0, 0, 0, 0, 19, 0, 0, 25, 15, 0, 0, 0, 0, 31, 0, 4, 0, 0, 0, 0, 0, 0, 0, 0, 0, 34, 71, 12, 0
Higher-100-Years-of-Boeing-by-Russ-Banham-_z-lib.org_, 0, 0, 0, 3, 15, 0, 0, 0, 0, 24, 0, 11, 0, 0, 0, 0, 0, 0, 0, 0, 0, 0, 0, 8, 0, 0, 0, 0, 0, 1, 0, 0, 0, 0, 0, 0, 0, 3, 1, 0, 1, 0, 102, 0, 20, 0, 0, 11, 0, 0, 0, 7, 0, 0, 0, 0, 0, 0, 0, 0, 12, 0, 2, 0, 1, 0, 0, 61, 0, 0, 0, 0, 0, 0, 0, 4, 0, 0, 1, 0, 0, 0, 0, 0, 0, 1, 0, 16, 0, 19, 0, 0, 13, 4, 0, 0, 0, 0, 0, 73, 0, 0, 0, 0, 0, 0, 0, 0, 1, 0, 0, 7, 0, 0, 0, 12, 0, 3, 234, 0, 0, 0, 0, 0, 42, 32, 41, 0, 0, 20, 2, 0, 0, 0, 0, 0, 0, 0, 0, 83, 0, 0, 0, 0, 0, 8, 17, 0, 0, 0, 0, 0, 0, 0, 2, 11, 77, 0, 3, 0, 0, 9, 0, 0, 0, 0, 0, 0, 0, 2, 1, 0, 0, 4, 3, 0, 3, 0, 1, 8, 0, 4, 0, 11, 0, 0, 0, 3, 0, 0, 0, 0, 5, 45, 1, 0, 0, 0, 8, 0, 17, 1, 0, 32, 0, 0, 7, 0, 1, 34, 5, 39, 2, 0, 1, 0, 0, 1, 0, 1, 0, 0, 0, 0, 0, 0, 0, 0, 0, 0, 0, 0, 0, 0, 0, 0, 24, 0, 2, 0, 0, 42, 10, 0, 0, 0, 0, 0, 0, 0, 6, 0, 0, 0, 3, 0, 53, 0, 0, 0, 0, 9, 3, 0, 0, 0, 68, 0, 0, 34, 2, 0, 23, 15, 1, 5, 0, 0, 0, 0, 2, 0, 0, 0, 4, 0, 0, 0, 0, 0, 0, 1, 0, 7, 0, 5, 0, 23, 0, 1, 81, 26, 0, 0, 0, 27, 15, 0, 0, 2, 14, 0, 0, 1, 0, 5, 0, 0, 0, 0, 10, 0, 0, 47, 0, 0, 0, 0, 2, 0, 0, 2, 0, 8, 0, 0, 0, 0, 0, 0, 1, 0, 0, 0, 0, 0, 10, 4, 0, 7, 0, 0, 2, 0, 7, 0, 0, 12, 0, 0, 5, 0, 2, 1, 0, 0, 0, 0, 10, 0, 0, 0, 2, 1, 0, 0, 10, 3, 0, 12, 0, 0, 0, 0, 0, 5, 0, 0, 1, 0, 0, 3, 0, 10, 0, 0, 0, 52, 0, 0, 0, 0, 0, 0, 0, 0, 13, 0, 0, 10, 15, 0, 0, 0, 1, 22, 0, 16, 0, 0, 0, 0, 0, 0, 0, 181, 0, 0, 10, 0, 0, 0, 0, 0, 0, 0, 1, 0, 5, 8, 0, 8, 0, 1, 3, 0, 0, 0, 0, 0, 0, 0, 1, 0, 2, 0, 24, 0, 0, 0, 0, 97, 0, 0, 16, 0, 17, 0, 0, 0, 22, 0, 0, 0, 0, 0, 1, 0, 0, 2, 0, 0, 0, 0, 0, 0, 7, 23, 0, 0, 0, 0, 0, 1, 0, 0, 3, 1, 138, 0, 0, 1, 0, 1, 0, 0, 0, 0, 0, 0, 0, 0, 2, 0, 13, 2, 0, 0, 0, 3, 0, 0, 8, 0, 0, 22, 0, 2, 0, 2, 4, 0, 0, 0, 0, 0, 3, 2, 0, 5, 4, 2, 0, 7, 6, 1, 0, 0, 0, 0, 0, 0, 3, 0, 0, 0, 1, 0, 0, 1, 1, 0, 0, 0, 0, 0, 0, 1, 0, 0, 1, 0, 23, 0, 0, 1, 2, 6, 0, 0, 2, 0, 0, 0, 1, 0, 0, 0, 0, 0, 0, 0, 1, 10, 0, 11, 0, 6, 0, 2, 0, 0, 0, 5, 0, 0, 0, 0, 0, 2, 13, 0, 1, 0, 9, 0, 0, 5, 2, 0, 0, 28, 0, 0, 8, 1, 0, 10, 0, 44, 0, 26, 0, 1, 0, 0, 5, 0, 0, 0, 0, 8, 0, 0, 15, 0, 9, 0, 0, 0, 0, 0, 1, 0, 33, 0, 0, 2, 0, 0, 0, 0, 11, 0, 0, 0, 2, 0, 1, 0, 0, 0, 0, 0, 2, 17, 0, 0, 0, 0, 0, 6, 0, 0, 4, 1, 0, 0, 2, 6, 0, 88, 0, 0, 0, 2, 0, 0, 0, 68, 19, 0, 5, 0, 0, 0, 13, 8, 0, 0, 0, 42, 0, 0, 18, 0, 5, 0, 0, 0, 0, 0, 0, 0, 0, 4, 0, 8, 0, 5, 0, 0, 0, 25, 0, 0, 0, 0, 0, 0, 0, 0, 2, 0, 0, 9, 1, 0, 0, 46, 0, 5, 2, 0, 0, 0, 0, 0, 0, 0, 1, 14, 0, 0, 0, 49, 0, 0, 7, 0, 1, 0, 0, 7, 41, 8, 13, 0, 0, 3, 51, 6, 0, 1, 0, 31, 8, 0, 6, 7, 0, 0, 0, 11, 0, 0, 84, 0, 0, 0, 0, 0, 0, 0, 0, 0, 1, 49, 0, 0, 0, 0, 0, 5, 0, 0, 0, 0, 2, 0, 0, 0, 0, 0, 0, 0, 0, 2, 12, 0, 2, 0, 0, 3, 0, 0, 5, 0, 0, 0, 1, 0, 0, 0, 0, 0, 0, 2, 7, 6, 5, 0, 0, 0, 0, 0, 7, 0, 0, 0, 0, 1, 0, 0, 0, 0, 1, 0, 0, 0, 0, 2, 0, 0, 0, 0, 0, 0, 0, 0, 0, 3, 65, 0, 0, 0, 1, 0, 0, 29, 24, 0, 6, 0, 0, 4, 0, 0, 1, 0, 0, 1, 11, 0, 0, 20, 0, 0, 0, 0, 0, 0, 0, 44, 0, 0, 0, 0, 0, 0, 0, 0, 0, 0, 0, 4, 0, 1, 0, 0, 0, 0, 0, 0, 7, 0, 0, 2, 0, 1, 0, 1, 4, 0, 0, 0, 0, 0, 0, 0, 0, 0, 0, 0, 1, 0, 0, 3, 4, 0, 4, 7, 0, 1, 0, 0, 0, 0, 0, 0, 0, 0, 0, 0, 5, 0, 0, 0, 5, 0, 0, 0, 3, 0, 0, 0, 20, 0, 0, 4, 0, 0, 0, 17, 0, 46, 10, 0, 0, 0, 0, 0, 0, 0, 0, 67, 0, 1, 4, 0, 0, 0, 0, 3, 0, 0, 10, 1, 1, 0, 3, 0, 0, 4, 0, 0, 0, 0, 0, 3, 3, 0, 0, 0, 0, 0, 0, 0, 14, 0, 26, 0, 0, 0, 0, 0, 0, 0, 0, 0, 0, 0, 41, 0, 0, 4, 0, 0, 0, 0, 0, 70, 0, 0, 1, 70, 0, 2, 0, 0, 0, 0, 2, 1, 0, 0, 12, 0, 4, 0, 0, 0, 0, 0, 0, 0, 0, 0, 1, 0, 0, 0, 0, 0, 18, 0, 3, 0, 2, 5, 32, 0, 0, 0, 2, 1, 4, 0, 0, 0, 0, 6, 0, 7, 0, 0, 0, 1, 1, 0, 0, 0, 0, 0, 2, 0, 1, 0, 0, 0, 0, 0, 58, 0, 7, 0, 9, 1, 0, 0, 0, 1, 0, 0, 0, 6, 0, 0, 0, 0, 0, 0, 0, 13, 0, 0, 1, 0, 4, 1, 0, 0, 0, 0, 0, 0, 0, 0, 0, 0, 0, 0, 3, 10, 1, 0, 0, 0, 0, 0, 0, 3, 0, 11, 0, 0, 15, 0, 0, 0, 0, 1, 0, 29, 0, 0, 2, 0, 0, 0, 2, 0, 0, 4, 0, 1, 4, 9, 0, 0, 0, 0, 0, 0, 0, 0, 0, 0, 0, 0, 0, 9, 8, 0, 20, 1, 1, 0, 0, 0, 0, 0, 0, 1, 0, 4, 3, 0, 0, 0, 66, 0, 0, 0, 5, 44, 0, 0, 30, 0, 0, 0, 0, 0, 3, 0, 0, 0, 0, 0, 1, 5, 14, 0, 0, 0, 0, 0, 43, 0, 8, 0, 0, 0, 2, 48, 0, 0, 0, 0, 0, 0, 0, 0, 0, 0, 2, 0, 0, 0, 0, 1, 0, 0, 0, 0, 0, 0, 209, 7, 0, 0, 1, 0, 0, 0, 0, 64, 0, 0, 0, 0, 2, 0, 0, 5, 2, 0, 6, 0, 30, 0, 0, 0, 5, 37, 0, 0, 0, 0, 0, 0, 15, 0, 0, 0, 26, 0, 29, 4, 2, 0, 0, 0, 0, 0, 0, 1, 0, 43, 1, 0, 0, 0, 0, 10, 0, 0, 0, 0, 0, 3, 0, 0, 0, 4, 5, 9, 1, 0, 1, 0, 0, 0, 7, 16, 0, 0, 0, 1, 0, 0, 0, 0, 0, 0, 0, 3, 0, 2, 0, 0, 0, 0, 0, 0, 0, 0, 0, 9, 0, 3, 0, 24, 0, 1, 0, 0, 37, 1, 0, 0, 0, 0, 0, 0, 0, 16, 3, 0, 3, 51, 0, 0, 11, 12, 0, 5, 0, 0, 0, 3, 0, 12, 0, 0, 0, 2, 0, 2, 0, 9, 17, 0, 0, 0, 0, 0, 0, 0, 8, 4, 1, 0, 0, 1, 9, 20, 0, 0, 0, 0, 0, 0, 0, 0, 0, 0, 0, 1, 0, 0, 0, 0, 0, 20, 0, 2, 0, 0, 0, 7, 1, 0, 0, 0, 0, 0, 0, 0, 0, 9, 17, 1, 0, 0, 0, 0, 52, 0, 5, 0, 0, 0, 0, 0, 1, 0, 0, 3, 0, 0, 19, 0, 1, 0, 1, 0, 0, 0, 0, 0, 2, 0, 62, 0, 1, 0, 0, 0, 0, 0, 0, 0, 0, 0, 0, 0, 0, 1, 0, 0, 1, 0, 0, 0, 2, 0, 0, 0, 0, 43, 0, 0, 0, 0, 0, 0, 0, 0, 0, 0, 0, 0, 32, 3, 1, 0, 0, 450, 0, 2, 0, 3, 0, 2, 0, 0, 0, 5, 0, 0, 0, 13, 3, 31, 0, 0, 0, 1, 0, 0, 0, 0, 0, 6, 0, 0, 0, 0, 0, 0, 0, 0, 0, 0, 1, 0, 0, 0, 3, 0, 1, 0, 1, 0, 2, 26, 0, 0, 5, 0, 3, 0, 0, 17, 11, 0, 0, 0, 0, 0, 0, 0, 9, 0, 0, 0, 0, 4, 0, 6, 0, 0, 2, 5, 0, 0, 0, 49, 0, 0, 18, 0, 2, 0, 0, 0, 0, 0, 0, 4, 0, 0, 32, 0, 0, 0, 0, 0, 0, 0, 3, 0, 0, 0, 0, 0, 0, 2, 0, 2, 0, 0, 0, 0, 0, 0, 0, 0, 3, 2, 0, 0, 1, 0, 0, 8, 0, 0, 5, 0, 38, 19, 0, 1, 0, 1, 210, 0, 17, 37, 0, 0, 0, 0, 109, 0, 1, 0, 2, 0, 0, 0, 0, 0, 0, 1, 8, 0, 0, 1, 81, 0, 0, 0, 0, 4, 0, 10, 0, 0, 0, 0, 0, 0, 0, 0, 0, 4, 6, 18, 0
iCon-Steve-Jobs-The-Greatest-Second-Act-in-the-History-of-Business-_Jeffrey-S.-Young_-William-L, 0, 0, 0, 12, 51, 0, 0, 0, 0, 41, 1, 9, 1, 0, 0, 0, 1, 0, 0, 0, 0, 0, 0, 10, 0, 0, 0, 0, 1, 0, 0, 0, 0, 0, 0, 0, 0, 0, 27, 0, 10, 0, 23, 0, 0, 0, 0, 3, 0, 0, 0, 42, 0, 0, 0, 3, 0, 0, 0, 0, 63, 0, 0, 0, 5, 0, 0, 13, 0, 2, 0, 0, 0, 0, 1, 0, 0, 0, 15, 0, 0, 0, 0, 0, 0, 26, 0, 1, 0, 115, 5, 0, 31, 3, 0, 0, 3, 0, 6, 6, 0, 0, 4, 0, 0, 0, 0, 0, 4, 0, 0, 27, 0, 0, 0, 44, 0, 6, 3, 0, 0, 0, 0, 0, 45, 223, 0, 23, 0, 0, 4, 0, 0, 0, 0, 0, 0, 0, 0, 1, 0, 0, 0, 0, 1, 4, 53, 0, 0, 0, 0, 0, 0, 0, 15, 27, 3, 0, 40, 0, 1, 39, 0, 0, 0, 0, 2, 16, 1, 0, 0, 0, 0, 24, 3, 0, 12, 0, 33, 43, 0, 9, 0, 30, 0, 0, 0, 67, 0, 4, 0, 0, 2, 4, 32, 0, 5, 62, 17, 0, 0, 3, 0, 47, 0, 0, 1, 0, 2, 6, 10, 34, 80, 0, 9, 0, 0, 0, 0, 21, 0, 3, 0, 0, 6, 0, 0, 0, 3, 0, 0, 1, 0, 0, 0, 0, 57, 0, 40, 0, 0, 7, 4, 24, 3, 0, 0, 0, 5, 0, 46, 0, 0, 0, 66, 0, 41, 0, 0, 0, 0, 5, 14, 292, 0, 0, 5, 0, 0, 17, 4, 0, 8, 3, 10, 53, 9, 0, 0, 0, 31, 0, 0, 0, 22, 0, 0, 0, 2, 27, 0, 22, 32, 1, 0, 1, 0, 52, 1, 12, 1, 82, 0, 0, 0, 20, 22, 0, 0, 43, 29, 0, 292, 0, 0, 43, 0, 19, 0, 0, 19, 0, 0, 8, 0, 0, 0, 0, 33, 0, 0, 13, 0, 33, 0, 0, 0, 0, 0, 0, 66, 0, 0, 0, 0, 0, 67, 0, 0, 4, 0, 4, 1, 0, 30, 0, 0, 159, 0, 0, 8, 0, 0, 1, 0, 0, 45, 0, 42, 5, 0, 0, 10, 38, 0, 0, 0, 22, 0, 126, 0, 0, 10, 0, 0, 9, 0, 0, 7, 0, 5, 22, 0, 0, 0, 0, 0, 1, 0, 0, 0, 0, 0, 94, 0, 0, 0, 0, 0, 24, 13, 0, 0, 2, 9, 0, 0, 0, 5, 0, 19, 0, 78, 5, 0, 2, 0, 0, 99, 0, 0, 1557, 0, 0, 0, 0, 25, 0, 73, 3, 0, 37, 0, 7, 121, 0, 1, 0, 0, 0, 0, 3, 1, 5, 59, 0, 45, 17, 2, 0, 0, 356, 2, 12, 2, 0, 27, 0, 0, 0, 0, 0, 0, 0, 0, 0, 0, 0, 0, 7, 0, 0, 0, 0, 0, 0, 7, 0, 11, 0, 0, 0, 0, 0, 0, 0, 6, 6, 14, 9, 0, 1, 0, 24, 0, 0, 0, 0, 0, 0, 0, 2, 1, 0, 41, 100, 0, 8, 0, 0, 0, 0, 14, 0, 0, 34, 0, 0, 0, 3, 3, 0, 0, 4, 0, 0, 0, 7, 0, 10, 12, 5, 0, 7, 2, 0, 18, 0, 0, 2, 0, 0, 0, 0, 0, 0, 28, 0, 0, 4, 39, 0, 0, 0, 0, 0, 0, 13, 0, 0, 67, 0, 0, 6, 0, 0, 3, 84, 3, 0, 0, 2, 0, 0, 12, 8, 0, 0, 1, 0, 0, 0, 12, 0, 0, 15, 0, 19, 0, 13, 0, 0, 1, 25, 0, 0, 0, 0, 3, 2, 10, 1, 22, 2, 7, 20, 0, 11, 1, 0, 0, 5, 0, 0, 70, 1, 0, 44, 4, 11, 0, 31, 0, 12, 0, 0, 68, 0, 0, 38, 0, 33, 0, 0, 0, 0, 42, 0, 0, 0, 0, 0, 8, 0, 2, 0, 0, 36, 0, 0, 0, 0, 28, 188, 0, 0, 3, 0, 3, 0, 0, 0, 1, 0, 3, 26, 3, 0, 0, 0, 0, 519, 0, 0, 44, 0, 0, 0, 21, 1, 0, 136, 0, 0, 15, 4, 1, 0, 0, 0, 22, 0, 0, 0, 0, 0, 152, 13, 0, 0, 0, 78, 0, 6, 10, 0, 4, 0, 0, 0, 0, 1, 1, 0, 0, 10, 0, 24, 0, 25, 0, 0, 37, 1, 0, 1, 0, 0, 0, 0, 0, 0, 0, 0, 0, 6, 0, 0, 0, 63, 0, 2, 17, 0, 0, 0, 35, 1, 0, 0, 6, 0, 0, 0, 0, 0, 0, 0, 10, 0, 1, 0, 0, 32, 0, 3, 7, 0, 0, 1, 49, 16, 0, 4, 2, 60, 2, 0, 19, 0, 0, 0, 0, 7, 1, 0, 87, 0, 1, 0, 0, 0, 0, 0, 0, 0, 0, 43, 0, 0, 0, 164, 0, 0, 0, 0, 0, 0, 17, 0, 0, 0, 17, 0, 0, 0, 0, 7, 10, 0, 43, 0, 4, 3, 0, 2, 3, 0, 0, 2, 2, 0, 0, 0, 1, 0, 678, 7, 22, 23, 16, 0, 1, 0, 0, 0, 39, 0, 0, 0, 0, 6, 0, 0, 0, 1, 5, 0, 1, 0, 0, 17, 1, 1, 0, 0, 10, 13, 1, 10, 2, 10, 8, 0, 0, 0, 38, 2, 0, 299, 6, 0, 3, 0, 0, 31, 0, 12, 0, 0, 0, 20, 9, 0, 0, 5, 0, 79, 4, 0, 0, 0, 0, 4, 0, 0, 0, 0, 1, 0, 0, 0, 0, 0, 0, 3, 0, 0, 0, 1, 0, 0, 3, 0, 19, 0, 0, 1, 1, 11, 0, 2, 5, 74, 0, 0, 0, 0, 0, 0, 4, 0, 0, 1, 9, 0, 0, 53, 0, 0, 12, 2, 0, 3, 0, 46, 0, 1, 1, 0, 0, 46, 0, 0, 1, 0, 0, 0, 19, 0, 0, 0, 27, 78, 214, 0, 106, 0, 0, 85, 0, 0, 1, 105, 0, 41, 0, 0, 0, 0, 0, 0, 0, 0, 0, 0, 0, 36, 10, 0, 0, 52, 0, 31, 18, 3, 0, 11, 9, 5, 1, 3, 0, 51, 0, 0, 0, 0, 0, 69, 2, 2, 0, 49, 0, 0, 0, 0, 3, 0, 44, 0, 0, 0, 50, 0, 0, 1, 0, 0, 8, 0, 17, 71, 0, 11, 0, 7, 0, 13, 0, 0, 0, 0, 1, 17, 2, 0, 0, 0, 0, 0, 37, 2, 0, 0, 8, 0, 16, 0, 0, 0, 0, 0, 0, 0, 0, 0, 15, 0, 0, 0, 0, 0, 21, 78, 22, 0, 0, 9, 88, 52, 0, 6, 41, 30, 0, 0, 0, 0, 0, 29, 0, 72, 0, 0, 0, 15, 5, 33, 0, 0, 0, 0, 0, 1, 32, 0, 0, 0, 0, 0, 16, 2, 113, 0, 126, 42, 0, 0, 0, 19, 0, 27, 25, 14, 0, 0, 0, 0, 0, 0, 3, 43, 0, 0, 0, 0, 11, 0, 0, 0, 0, 0, 0, 0, 0, 0, 0, 2, 0, 0, 3, 15, 0, 5, 0, 0, 0, 0, 0, 27, 0, 4, 0, 0, 2, 1, 0, 0, 0, 2, 1, 30, 0, 0, 11, 0, 0, 0, 4, 1, 0, 23, 0, 4, 16, 96, 0, 0, 0, 25, 0, 0, 0, 0, 0, 0, 0, 0, 0, 30, 0, 0, 51, 8, 1, 1, 0, 0, 0, 0, 0, 27, 0, 30, 9, 0, 0, 0, 18, 4, 0, 0, 29, 0, 0, 0, 1, 4, 0, 0, 0, 0, 0, 0, 0, 0, 4, 6, 0, 0, 177, 0, 0, 2, 0, 0, 0, 0, 125, 0, 0, 0, 5, 10, 0, 0, 0, 0, 55, 0, 0, 0, 0, 0, 0, 56, 0, 0, 0, 0, 0, 0, 9, 1, 0, 0, 551, 8, 0, 0, 17, 0, 0, 0, 0, 4, 2, 1, 0, 0, 12, 2, 0, 79, 7, 1, 2, 2, 1, 0, 1, 0, 13, 0, 0, 0, 0, 5, 0, 0, 26, 1, 0, 0, 43, 15, 15, 147, 3, 0, 0, 0, 0, 1, 1, 0, 0, 8, 54, 0, 0, 1, 0, 0, 2, 0, 0, 0, 0, 0, 0, 0, 16, 95, 34, 173, 0, 0, 13, 6, 0, 0, 17, 6, 0, 0, 0, 7, 0, 0, 0, 0, 0, 0, 43, 7, 0, 12, 0, 0, 0, 12, 0, 0, 0, 2, 0, 7, 0, 27, 0, 5, 0, 3, 0, 7, 49, 0, 0, 0, 0, 0, 0, 0, 0, 7, 24, 0, 4, 43, 0, 0, 10, 6, 1, 19, 0, 0, 2, 9, 0, 99, 0, 0, 0, 0, 0, 2, 0, 7, 0, 0, 0, 13, 12, 1, 0, 0, 11, 8, 28, 0, 0, 13, 0, 37, 0, 0, 0, 3, 0, 0, 0, 0, 0, 1, 0, 0, 8, 0, 0, 0, 0, 3, 10, 22, 0, 1, 0, 3, 19, 0, 0, 1, 0, 0, 3, 0, 49, 0, 15, 0, 0, 40, 1, 0, 169, 45, 0, 0, 0, 0, 0, 0, 1, 0, 0, 1, 3, 0, 16, 0, 0, 29, 4, 0, 0, 0, 0, 0, 7, 0, 2, 0, 8, 0, 0, 0, 0, 0, 0, 0, 0, 36, 0, 0, 0, 1, 0, 0, 0, 0, 0, 0, 5, 0, 0, 0, 3, 7, 0, 0, 0, 0, 0, 0, 10, 0, 22, 0, 0, 0, 0, 3, 0, 0, 0, 0, 1, 121, 1, 0, 0, 7, 5, 0, 0, 78, 92, 0, 0, 28, 13, 51, 0, 0, 7, 6, 0, 0, 2, 1, 0, 11, 8, 0, 0, 0, 0, 0, 0, 0, 37, 0, 150, 0, 0, 0, 51, 1, 6, 0, 0, 0, 4, 5, 0, 3, 22, 2, 91, 0, 0, 39, 56, 0, 0, 2, 0, 0, 0, 0, 12, 0, 0, 0, 13, 3, 29, 0, 0, 0, 12, 20, 0, 0, 1, 10, 1, 0, 84, 0, 33, 0, 0, 0, 0, 0, 2, 50, 1, 18, 65, 2, 0, 0, 0, 0, 1, 0, 1, 1, 0, 0, 0, 0, 0, 39, 0, 24, 0, 0, 0, 2, 0, 0, 0, 18, 13, 44, 0, 0, 7, 1, 0, 25, 4, 0, 0, 0, 122, 88, 0, 3, 0, 3, 2, 0, 2, 7, 0, 1, 0, 0, 1, 15, 19, 0, 31, 0, 0, 0, 0, 0, 0, 0, 26, 0, 0, 3, 18, 0, 0, 0, 0, 51, 0, 17, 0, 0, 0, 0, 0, 0, 0, 1, 0, 39, 79, 5, 0
Im-Feeling-Lucky-The-Confessions-of-Google-Employee-Number-59-by-Douglas-Edwards-_z-lib.org_, 0, 0, 0, 57, 45, 0, 0, 0, 0, 34, 13, 5, 1, 0, 0, 0, 2, 0, 0, 0, 0, 0, 0, 36, 0, 0, 0, 0, 1, 0, 0, 0, 1, 0, 0, 0, 1, 1, 113, 0, 15, 0, 23, 0, 0, 0, 0, 7, 5, 0, 0, 28, 0, 0, 0, 0, 0, 0, 0, 0, 55, 0, 0, 0, 1, 142, 5, 6, 0, 1, 0, 0, 0, 0, 7, 0, 2, 0, 37, 0, 0, 0, 0, 0, 0, 50, 0, 1, 0, 59, 55, 0, 28, 0, 0, 0, 2, 0, 18, 5, 2, 0, 0, 0, 0, 0, 0, 0, 3, 0, 66, 30, 0, 0, 0, 41, 3, 3, 0, 0, 1, 0, 0, 0, 7, 256, 1, 0, 0, 1, 5, 0, 0, 0, 0, 0, 0, 0, 0, 3, 0, 0, 0, 0, 1, 16, 79, 0, 0, 0, 0, 0, 0, 0, 77, 7, 69, 0, 44, 2, 7, 38, 0, 0, 1, 0, 8, 1, 6, 0, 0, 0, 0, 28, 1, 0, 0, 0, 46, 2, 0, 50, 0, 28, 0, 0, 0, 14, 0, 4, 0, 0, 1, 1, 12, 0, 0, 2, 41, 0, 0, 3, 0, 57, 0, 0, 2, 0, 9, 0, 23, 48, 8, 0, 2, 0, 1, 0, 0, 17, 0, 1, 0, 0, 7, 0, 0, 0, 6, 0, 0, 2, 0, 0, 0, 0, 55, 0, 23, 0, 0, 5, 7, 19, 1, 0, 0, 0, 2, 0, 54, 0, 0, 0, 56, 0, 30, 1, 0, 0, 2, 9, 32, 3, 1, 0, 1, 0, 0, 12, 25, 0, 7, 19, 13, 38, 1, 0, 0, 0, 35, 0, 0, 0, 33, 0, 0, 0, 1, 31, 0, 13, 37, 0, 0, 3, 0, 36, 1, 11, 0, 114, 0, 0, 0, 12, 60, 0, 0, 3, 17, 0, 0, 0, 7, 16, 0, 3, 0, 0, 11, 0, 0, 6, 0, 0, 0, 0, 34, 0, 0, 20, 0, 30, 4, 15, 0, 0, 0, 0, 2, 0, 0, 0, 0, 0, 79, 0, 0, 2, 0, 4, 4, 0, 106, 0, 0, 45, 0, 0, 43, 0, 0, 2, 0, 0, 15, 1, 11, 0, 0, 0, 5, 5, 0, 0, 5, 25, 0, 69, 0, 0, 25, 4, 1, 7, 0, 0, 5, 0, 4, 32, 0, 0, 0, 0, 0, 1, 1, 0, 0, 0, 0, 0, 0, 7, 0, 0, 0, 17, 5, 0, 0, 1296, 11, 1, 0, 0, 0, 0, 0, 0, 12, 2, 0, 10, 0, 1, 140, 0, 0, 3, 0, 0, 0, 0, 28, 1, 23, 3, 0, 39, 0, 1, 56, 0, 0, 0, 0, 0, 0, 0, 0, 6, 77, 0, 37, 19, 1, 1, 0, 373, 166, 3, 4, 0, 13, 0, 0, 0, 0, 0, 0, 0, 0, 0, 1, 0, 0, 20, 0, 0, 1, 0, 0, 0, 13, 0, 10, 0, 0, 0, 0, 0, 0, 0, 16, 2, 26, 34, 0, 1, 0, 31, 0, 0, 0, 0, 0, 0, 0, 0, 1, 45, 54, 94, 0, 12, 0, 0, 4, 0, 51, 0, 0, 22, 0, 2, 0, 3, 6, 0, 0, 0, 0, 0, 3, 10, 0, 3, 34, 5, 0, 4, 0, 0, 0, 1, 0, 0, 0, 10, 2, 0, 0, 0, 64, 0, 0, 10, 63, 22, 0, 0, 0, 0, 5, 16, 0, 0, 30, 0, 0, 1, 0, 0, 1, 93, 0, 1, 1, 0, 0, 0, 0, 3, 0, 0, 0, 0, 0, 0, 27, 0, 0, 14, 0, 15, 0, 6, 0, 0, 2, 75, 0, 0, 0, 0, 8, 1, 5, 0, 22, 0, 2, 0, 0, 17, 2, 0, 0, 3, 0, 0, 134, 0, 0, 49, 1, 14, 0, 16, 0, 13, 0, 0, 37, 0, 0, 2, 0, 38, 0, 0, 2, 0, 72, 11, 91, 0, 12, 0, 5, 0, 2, 1, 0, 24, 0, 0, 154, 0, 63, 0, 1, 75, 0, 0, 4, 0, 0, 0, 0, 0, 1, 54, 0, 1, 0, 0, 0, 86, 0, 0, 115, 1, 0, 0, 27, 2, 0, 40, 0, 0, 3, 5, 0, 0, 0, 1, 56, 6, 0, 0, 0, 0, 185, 5, 0, 0, 0, 9, 0, 0, 52, 1, 36, 0, 0, 0, 0, 3, 0, 0, 0, 21, 0, 3, 0, 6, 0, 0, 67, 3, 0, 3, 0, 0, 0, 0, 0, 0, 0, 4, 0, 14, 0, 0, 0, 79, 0, 2, 22, 0, 29, 0, 0, 1, 1, 0, 0, 0, 0, 0, 0, 0, 0, 0, 32, 0, 0, 0, 0, 122, 1, 3, 10, 0, 0, 1, 292, 0, 0, 24, 0, 42, 2, 0, 25, 3, 0, 0, 0, 36, 0, 0, 24, 0, 0, 0, 0, 0, 0, 0, 0, 0, 0, 39, 0, 0, 0, 7, 0, 0, 1, 0, 0, 0, 25, 91, 0, 0, 3, 0, 0, 0, 0, 20, 18, 2, 9, 0, 8, 3, 0, 0, 0, 55, 0, 1, 1, 0, 1, 0, 1, 1, 9, 15, 64, 36, 20, 2, 2, 0, 0, 0, 8, 0, 0, 0, 0, 7, 0, 0, 0, 0, 7, 0, 0, 0, 0, 534, 5, 0, 0, 0, 2, 8, 0, 5, 1, 24, 10, 1, 0, 2, 7, 0, 0, 286, 39, 0, 4, 1, 0, 45, 0, 24, 1, 0, 2, 3, 57, 1, 0, 3, 0, 0, 1, 0, 0, 0, 0, 14, 0, 0, 0, 0, 2, 0, 0, 0, 0, 0, 0, 11, 0, 1, 0, 1, 0, 0, 19, 68, 5, 0, 0, 2, 4, 74, 0, 1, 21, 0, 0, 0, 0, 0, 0, 0, 3, 0, 0, 2, 33, 0, 0, 71, 1, 0, 9, 7, 0, 5, 39, 15, 0, 9, 0, 0, 0, 10, 0, 0, 12, 0, 0, 0, 10, 0, 0, 0, 16, 0, 0, 0, 76, 0, 0, 78, 0, 0, 0, 94, 0, 52, 0, 0, 0, 0, 2, 0, 0, 0, 0, 0, 1, 27, 36, 29, 0, 0, 0, 36, 4, 2, 0, 75, 8, 0, 2, 1, 0, 18, 0, 0, 0, 0, 0, 47, 6, 41, 0, 0, 1, 0, 0, 0, 7, 0, 52, 0, 0, 0, 0, 0, 0, 5, 0, 0, 11, 0, 120, 1, 0, 7, 0, 0, 0, 3, 0, 1, 0, 6, 2, 3, 0, 4, 0, 0, 0, 0, 62, 0, 0, 0, 42, 0, 23, 0, 0, 0, 2, 0, 0, 0, 0, 0, 9, 0, 0, 0, 0, 0, 13, 0, 8, 0, 0, 2, 61, 204, 0, 1, 40, 31, 1, 0, 0, 0, 0, 16, 0, 112, 0, 0, 0, 10, 16, 0, 0, 0, 0, 0, 0, 2, 87, 0, 0, 0, 0, 2, 24, 0, 84, 0, 40, 416, 0, 0, 0, 45, 0, 60, 8, 11, 3, 0, 0, 0, 0, 0, 6, 65, 0, 1, 2, 0, 9, 0, 0, 0, 0, 0, 0, 2, 0, 0, 0, 4, 0, 0, 1, 16, 1, 0, 0, 0, 0, 0, 0, 75, 8, 10, 0, 0, 0, 0, 0, 0, 0, 4, 1, 27, 0, 0, 15, 2, 0, 0, 1, 1, 0, 22, 0, 2, 135, 110, 0, 0, 0, 0, 11, 0, 33, 0, 0, 0, 0, 0, 0, 219, 0, 0, 68, 4, 1, 1, 0, 0, 0, 0, 8, 17, 0, 26, 8, 0, 0, 0, 59, 0, 0, 0, 24, 1, 0, 0, 1, 0, 0, 2, 0, 0, 1, 0, 0, 0, 4, 1, 1, 3, 308, 0, 0, 16, 0, 0, 0, 0, 33, 0, 0, 0, 2, 25, 1, 0, 0, 0, 4, 0, 0, 0, 0, 0, 2, 0, 0, 0, 0, 0, 0, 0, 11, 0, 0, 0, 355, 199, 0, 0, 4, 0, 0, 0, 0, 4, 8, 1, 0, 0, 10, 1, 0, 98, 2, 0, 2, 7, 8, 0, 0, 0, 8, 0, 0, 0, 0, 1, 0, 0, 40, 0, 50, 0, 43, 8, 29, 136, 44, 0, 0, 0, 0, 0, 0, 0, 0, 0, 1, 0, 0, 0, 0, 0, 0, 0, 0, 0, 0, 6, 0, 0, 15, 112, 17, 16, 1, 0, 7, 1, 0, 0, 13, 46, 1, 0, 0, 15, 0, 0, 0, 0, 0, 9, 0, 22, 0, 8, 0, 0, 0, 2, 0, 0, 0, 8, 0, 2, 0, 4, 0, 17, 0, 1, 0, 4, 80, 1, 0, 0, 0, 0, 0, 0, 1, 23, 8, 0, 0, 153, 1, 0, 24, 7, 26, 22, 0, 22, 2, 6, 0, 109, 0, 0, 0, 1, 0, 2, 0, 7, 1, 0, 0, 0, 16, 2, 0, 0, 46, 3, 23, 0, 0, 10, 0, 49, 0, 0, 0, 3, 2, 0, 0, 0, 0, 2, 21, 132, 1, 0, 0, 0, 0, 22, 6, 21, 0, 0, 0, 2, 3, 0, 0, 0, 0, 0, 0, 0, 33, 0, 5, 0, 1, 0, 1, 0, 121, 30, 1, 0, 0, 0, 0, 2, 0, 0, 0, 0, 0, 0, 117, 0, 0, 0, 2, 0, 0, 1, 0, 0, 14, 0, 1, 0, 11, 0, 0, 0, 0, 1, 0, 0, 0, 48, 0, 0, 0, 0, 0, 0, 0, 0, 0, 0, 9, 0, 0, 0, 8, 2, 0, 0, 0, 0, 0, 0, 525, 0, 34, 0, 0, 0, 0, 1, 1, 0, 0, 1, 0, 1, 0, 0, 0, 3, 9, 4, 0, 42, 1, 0, 1, 67, 35, 76, 0, 0, 1, 1, 0, 0, 3, 0, 0, 5, 2, 0, 0, 0, 0, 0, 0, 0, 20, 0, 53, 0, 0, 0, 26, 0, 9, 0, 0, 0, 2, 0, 0, 0, 0, 4, 83, 0, 0, 64, 25, 2, 0, 0, 0, 0, 0, 0, 7, 0, 0, 0, 0, 22, 0, 0, 2, 0, 24, 23, 0, 0, 1, 13, 1, 0, 118, 0, 30, 0, 0, 0, 0, 0, 126, 61, 0, 55, 100, 27, 0, 0, 0, 1, 1, 0, 0, 0, 0, 0, 0, 0, 0, 84, 0, 41, 0, 30, 0, 3, 0, 0, 0, 3, 7, 11, 483, 0, 21, 0, 0, 30, 0, 0, 0, 0, 111, 121, 2, 0, 0, 2, 6, 0, 3, 2, 0, 4, 0, 0, 0, 0, 26, 0, 15, 0, 0, 5, 0, 0, 9, 1, 25, 0, 0, 3, 9, 0, 0, 0, 0, 25, 0, 16, 0, 0, 0, 0, 1, 0, 0, 2, 1, 4, 85, 3, 1
John Chambers and the Cisco Way Navigating Through Volatility by John K. Waters (z-lib.org), 0, 0, 0, 15, 131, 0, 0, 0, 0, 19, 0, 24, 0, 0, 0, 28, 0, 0, 0, 0, 0, 0, 0, 123, 4, 0, 0, 0, 1, 7, 0, 0, 1, 0, 0, 1, 0, 0, 23, 0, 1, 0, 2, 0, 0, 0, 0, 92, 1, 0, 0, 9, 0, 57, 0, 0, 0, 0, 0, 0, 30, 0, 0, 0, 1, 0, 0, 11, 0, 0, 0, 0, 0, 0, 0, 0, 0, 0, 4, 0, 0, 0, 0, 0, 0, 13, 0, 0, 0, 29, 0, 0, 6, 0, 0, 0, 2, 0, 12, 0, 0, 2, 0, 0, 1, 0, 0, 0, 0, 0, 0, 9, 0, 0, 0, 4, 0, 0, 0, 0, 0, 0, 0, 0, 0, 49, 0, 0, 0, 0, 4, 0, 0, 0, 0, 0, 0, 0, 0, 2, 0, 0, 0, 0, 0, 3, 31, 0, 0, 0, 1, 0, 0, 0, 13, 0, 1, 0, 23, 0, 0, 11, 0, 0, 6, 0, 1, 0, 1, 6, 0, 0, 0, 11, 36, 0, 1, 0, 5, 14, 0, 13, 0, 16, 20, 0, 0, 5, 0, 4, 0, 0, 2, 0, 8, 1, 0, 60, 35, 0, 0, 0, 0, 33, 0, 0, 0, 0, 0, 14, 5, 6, 1, 0, 2, 0, 0, 0, 0, 3, 0, 0, 1, 0, 5, 0, 0, 0, 3, 0, 0, 0, 0, 0, 0, 0, 4, 0, 8, 0, 0, 2, 1, 11, 0, 0, 0, 0, 12, 0, 74, 0, 0, 0, 36, 66, 17, 0, 0, 0, 0, 0, 2, 0, 0, 0, 0, 0, 0, 4, 4, 0, 13, 1, 7, 8, 0, 0, 0, 0, 7, 0, 0, 0, 1, 0, 0, 0, 0, 7, 0, 7, 63, 0, 0, 6, 0, 18, 0, 2, 2, 116, 2, 0, 0, 20, 35, 0, 0, 5, 3, 0, 0, 0, 1, 5, 0, 2, 0, 1, 13, 0, 0, 5, 0, 0, 0, 0, 12, 0, 0, 1, 0, 5, 2, 0, 0, 0, 0, 0, 0, 0, 0, 0, 0, 0, 13, 0, 0, 1, 0, 1, 1, 0, 36, 0, 0, 24, 0, 0, 7, 0, 0, 1, 0, 1, 3, 0, 24, 0, 0, 0, 9, 4, 0, 0, 10, 17, 0, 62, 0, 0, 2, 0, 1, 7, 0, 0, 2, 0, 0, 18, 0, 0, 0, 0, 0, 1, 0, 0, 0, 0, 0, 0, 0, 0, 0, 31, 0, 14, 7, 0, 0, 0, 8, 1, 0, 0, 0, 0, 0, 0, 0, 12, 0, 2, 0, 0, 24, 0, 0, 4, 0, 0, 0, 0, 50, 0, 36, 0, 0, 19, 0, 1, 25, 0, 0, 0, 0, 37, 0, 0, 0, 8, 16, 0, 14, 32, 0, 0, 0, 137, 1, 0, 0, 0, 23, 0, 0, 0, 0, 0, 0, 0, 0, 0, 0, 0, 0, 1, 0, 0, 3, 0, 0, 0, 6, 0, 2, 0, 0, 0, 0, 0, 0, 0, 1, 0, 3, 4, 0, 0, 0, 10, 0, 0, 0, 0, 0, 0, 0, 12, 1, 0, 13, 49, 0, 3, 0, 0, 0, 0, 17, 1, 0, 18, 0, 0, 0, 2, 4, 0, 0, 0, 0, 0, 0, 1, 0, 1, 5, 0, 0, 1, 0, 0, 0, 0, 0, 0, 0, 3, 1, 0, 0, 0, 31, 0, 0, 0, 135, 0, 0, 0, 0, 0, 0, 3, 0, 0, 18, 0, 0, 1, 0, 0, 1, 17, 0, 0, 0, 0, 0, 0, 2, 0, 0, 0, 0, 0, 0, 14, 13, 0, 0, 9, 0, 6, 0, 10, 0, 0, 0, 19, 0, 0, 0, 0, 1, 5, 8, 0, 7, 2, 7, 1, 0, 4, 1, 0, 0, 3, 0, 0, 20, 1, 0, 17, 1, 11, 0, 22, 0, 2, 0, 0, 14, 0, 0, 4, 0, 25, 0, 0, 1, 0, 33, 0, 0, 0, 0, 0, 4, 0, 2, 1, 0, 17, 0, 0, 0, 0, 45, 1, 0, 0, 0, 0, 0, 0, 0, 0, 0, 0, 14, 5, 0, 0, 0, 0, 0, 57, 0, 0, 17, 1, 3, 0, 0, 0, 0, 13, 0, 0, 1, 0, 11, 0, 0, 0, 132, 1, 0, 0, 0, 0, 30, 13, 0, 0, 0, 44, 0, 2, 21, 1, 15, 0, 0, 0, 0, 0, 0, 0, 0, 14, 0, 0, 0, 5, 0, 0, 6, 5, 0, 0, 0, 0, 0, 0, 0, 0, 0, 0, 0, 1, 0, 0, 2, 24, 0, 0, 1, 0, 0, 0, 0, 0, 0, 0, 7, 0, 0, 0, 0, 0, 0, 0, 6, 0, 0, 0, 0, 27, 3, 0, 10, 0, 3, 10, 13, 0, 0, 1, 0, 13, 4, 0, 23, 0, 0, 0, 0, 9, 0, 0, 88, 0, 0, 0, 0, 0, 0, 0, 0, 0, 0, 14, 0, 0, 0, 3, 0, 0, 0, 0, 0, 0, 9, 0, 0, 0, 2, 0, 0, 0, 0, 1, 3, 0, 11, 0, 1, 6, 0, 0, 0, 0, 0, 0, 0, 0, 0, 0, 0, 0, 10, 1, 37, 22, 5, 0, 3, 0, 0, 0, 28, 0, 0, 0, 0, 8, 0, 0, 1, 0, 3, 0, 0, 0, 0, 4, 0, 2, 0, 0, 4, 2, 0, 0, 0, 9, 7, 0, 0, 0, 5, 0, 0, 116, 18, 0, 1, 0, 0, 15, 0, 6, 0, 0, 0, 6, 9, 0, 0, 7, 0, 0, 0, 0, 0, 0, 0, 13, 0, 0, 0, 0, 9, 0, 0, 0, 0, 0, 0, 2, 0, 0, 0, 0, 14, 0, 1, 1, 13, 0, 0, 0, 16, 13, 0, 1, 35, 0, 0, 0, 0, 0, 0, 0, 6, 0, 0, 1, 1, 4, 0, 11, 0, 0, 20, 3, 0, 0, 0, 3, 0, 0, 0, 0, 0, 1, 1, 0, 3, 0, 0, 0, 12, 0, 0, 0, 3, 0, 0, 0, 18, 0, 20, 20, 0, 0, 1, 57, 0, 18, 0, 0, 0, 0, 0, 0, 0, 0, 0, 0, 0, 2, 3, 7, 0, 0, 2, 11, 10, 0, 0, 3, 22, 1, 0, 0, 0, 11, 0, 0, 0, 0, 0, 6, 1, 1, 0, 0, 3, 0, 0, 0, 1, 0, 27, 0, 0, 0, 1, 0, 0, 7, 0, 16, 0, 0, 55, 0, 0, 5, 0, 0, 0, 2, 0, 2, 0, 1, 1, 8, 460, 0, 0, 0, 0, 0, 25, 0, 0, 0, 10, 0, 2, 0, 0, 0, 1, 0, 0, 0, 0, 0, 8, 0, 0, 0, 0, 0, 12, 0, 9, 0, 0, 0, 119, 15, 0, 1, 14, 14, 0, 0, 0, 3, 0, 10, 0, 18, 0, 0, 0, 19, 8, 0, 0, 0, 0, 0, 0, 1, 21, 0, 0, 0, 0, 0, 24, 9, 20, 0, 52, 10, 0, 0, 0, 88, 0, 2, 12, 4, 1, 0, 0, 0, 0, 0, 7, 70, 0, 0, 1, 0, 10, 0, 0, 0, 0, 0, 0, 0, 0, 0, 0, 0, 0, 0, 1, 12, 2, 0, 0, 0, 0, 0, 0, 29, 0, 10, 0, 0, 0, 0, 0, 0, 0, 0, 1, 15, 0, 0, 21, 0, 0, 0, 5, 0, 0, 7, 0, 2, 9, 28, 0, 0, 0, 0, 0, 0, 0, 0, 0, 0, 0, 0, 0, 9, 21, 0, 29, 2, 2, 1, 0, 0, 0, 0, 0, 11, 0, 10, 0, 0, 0, 0, 5, 0, 0, 0, 3, 5, 0, 0, 0, 1, 0, 0, 0, 0, 2, 0, 0, 0, 0, 0, 1, 5, 64, 0, 0, 1, 0, 0, 0, 0, 23, 2, 0, 0, 2, 26, 0, 0, 0, 0, 0, 0, 0, 1, 0, 1, 2, 1, 0, 0, 0, 1, 0, 0, 0, 0, 0, 0, 603, 47, 0, 0, 12, 0, 0, 0, 0, 0, 86, 1, 0, 0, 5, 1, 0, 66, 0, 0, 2, 0, 0, 0, 8, 0, 16, 0, 0, 0, 0, 5, 0, 0, 15, 0, 0, 0, 10, 4, 8, 58, 6, 0, 0, 0, 0, 0, 0, 1, 0, 2, 7, 0, 0, 0, 0, 0, 3, 0, 0, 0, 0, 31, 0, 0, 5, 21, 3, 124, 0, 0, 5, 1, 4, 0, 28, 22, 0, 0, 0, 2, 0, 0, 0, 0, 0, 1, 0, 8, 0, 3, 1, 0, 0, 6, 0, 0, 0, 1, 0, 2, 0, 13, 0, 5, 0, 0, 0, 1, 27, 0, 0, 0, 0, 0, 0, 0, 2, 0, 6, 0, 0, 12, 0, 2, 13, 1, 17, 13, 0, 0, 2, 13, 0, 34, 0, 0, 0, 0, 0, 0, 0, 3, 0, 0, 0, 0, 11, 0, 0, 0, 57, 5, 8, 0, 0, 3, 0, 13, 0, 0, 0, 0, 0, 0, 0, 0, 0, 0, 18, 0, 3, 0, 0, 0, 0, 18, 1, 15, 0, 0, 0, 0, 7, 0, 20, 0, 0, 0, 0, 0, 8, 0, 9, 0, 0, 0, 1, 0, 121, 21, 1, 0, 0, 0, 0, 0, 0, 0, 0, 5, 1, 2, 8, 0, 0, 0, 3, 0, 0, 1, 0, 0, 4, 0, 2, 0, 3, 0, 0, 0, 0, 0, 0, 0, 0, 14, 1, 0, 0, 2, 0, 0, 2, 0, 0, 0, 3, 0, 0, 0, 3, 10, 0, 0, 0, 0, 0, 0, 5, 0, 35, 9, 0, 0, 0, 3, 0, 0, 0, 5, 1, 0, 0, 0, 0, 11, 4, 4, 0, 24, 0, 0, 0, 27, 42, 9, 0, 0, 0, 0, 6, 0, 0, 1, 0, 14, 1, 0, 0, 0, 0, 0, 0, 0, 5, 0, 32, 0, 0, 0, 8, 4, 0, 0, 0, 0, 1, 0, 0, 0, 0, 0, 33, 0, 0, 18, 2, 38, 0, 0, 0, 0, 0, 0, 2, 0, 0, 0, 0, 14, 0, 0, 0, 0, 14, 18, 0, 0, 0, 6, 658, 1, 38, 0, 19, 0, 0, 0, 0, 0, 0, 15, 0, 7, 12, 3, 0, 0, 0, 0, 2, 0, 4, 0, 0, 0, 0, 0, 0, 13, 0, 23, 0, 0, 0, 2, 0, 0, 0, 2, 16, 11, 0, 0, 7, 0, 0, 8, 0, 0, 0, 0, 20, 41, 9, 0, 0, 3, 1, 0, 0, 1, 0, 15, 0, 0, 0, 2, 12, 0, 2, 0, 0, 3, 0, 0, 9, 0, 8, 0, 0, 6, 4, 0, 0, 0, 3, 20, 0, 12, 0, 0, 0, 0, 0, 0, 0, 1, 0, 33, 18, 7, 0
JPMorgans-Fall-and-Revival-by-Nicholas-P.-Sargen-_z-lib.org_, 0, 0, 0, 45, 55, 0, 0, 0, 0, 43, 0, 9, 0, 0, 0, 0, 18, 0, 0, 0, 0, 0, 0, 12, 0, 0, 0, 0, 0, 4, 4, 0, 0, 43, 0, 0, 0, 1, 66, 0, 3, 0, 27, 1, 0, 0, 0, 39, 0, 0, 0, 18, 0, 0, 13, 0, 0, 0, 0, 0, 36, 8, 0, 14, 111, 0, 0, 73, 32, 0, 0, 0, 0, 0, 2, 0, 0, 0, 66, 0, 0, 0, 0, 39, 0, 9, 0, 4, 0, 61, 0, 0, 2, 3, 0, 0, 0, 0, 5, 7, 49, 0, 0, 0, 0, 0, 0, 0, 106, 0, 0, 11, 0, 1, 0, 28, 0, 0, 0, 0, 0, 0, 0, 19, 4, 54, 0, 0, 0, 0, 11, 0, 0, 100, 0, 0, 0, 1, 0, 3, 0, 0, 0, 0, 0, 3, 52, 0, 0, 0, 0, 0, 0, 0, 10, 35, 0, 0, 40, 8, 0, 3, 0, 0, 0, 0, 10, 1, 17, 2, 0, 1, 3, 41, 2, 0, 1, 0, 29, 80, 0, 70, 0, 15, 0, 0, 0, 2, 0, 5, 0, 0, 0, 0, 111, 2, 0, 1, 27, 0, 0, 57, 0, 76, 0, 0, 0, 0, 6, 0, 27, 10, 2, 0, 10, 0, 0, 2, 0, 13, 0, 0, 0, 0, 2, 0, 0, 0, 0, 1, 3, 0, 0, 0, 0, 0, 10, 0, 1, 0, 0, 7, 34, 12, 0, 0, 0, 2, 0, 0, 18, 0, 0, 0, 107, 0, 29, 0, 0, 0, 0, 17, 1, 0, 0, 0, 0, 0, 0, 5, 2, 0, 28, 2, 193, 3, 0, 0, 3, 0, 6, 0, 0, 0, 3, 0, 0, 0, 0, 1, 0, 23, 1, 7, 0, 0, 0, 22, 1, 12, 3, 32, 1, 0, 0, 178, 24, 0, 0, 0, 55, 0, 0, 4, 2, 9, 3, 6, 0, 0, 9, 0, 0, 18, 0, 0, 0, 0, 30, 0, 0, 3, 0, 11, 3, 0, 0, 0, 0, 0, 0, 0, 0, 0, 0, 0, 58, 54, 0, 10, 2, 95, 2, 0, 35, 1, 0, 46, 0, 0, 12, 0, 4, 0, 0, 0, 1, 0, 18, 0, 0, 0, 0, 5, 0, 0, 39, 0, 1, 22, 0, 0, 3, 1, 0, 17, 2, 0, 7, 0, 113, 8, 1, 0, 0, 0, 0, 2, 0, 0, 0, 0, 6, 0, 0, 0, 0, 1, 0, 94, 9, 0, 0, 0, 7, 0, 0, 0, 0, 0, 0, 0, 0, 0, 0, 0, 0, 0, 30, 0, 0, 0, 0, 0, 8, 0, 1, 0, 17, 0, 0, 47, 0, 40, 9, 0, 0, 0, 0, 0, 0, 6, 4, 2, 2, 0, 69, 33, 0, 0, 0, 213, 0, 0, 3, 0, 20, 0, 0, 0, 0, 0, 0, 0, 0, 0, 0, 0, 0, 3, 0, 0, 78, 0, 0, 22, 14, 1, 0, 0, 0, 0, 0, 1, 0, 0, 0, 0, 1, 164, 0, 0, 0, 3, 0, 0, 0, 0, 0, 0, 0, 25, 4, 0, 61, 11, 0, 0, 0, 0, 0, 0, 21, 0, 0, 47, 0, 0, 0, 0, 20, 0, 0, 0, 0, 4, 0, 2, 0, 0, 21, 1, 0, 0, 11, 0, 0, 4, 0, 0, 0, 1, 4, 0, 0, 0, 71, 0, 0, 13, 11, 0, 0, 0, 0, 0, 0, 0, 0, 0, 14, 1, 0, 2, 0, 0, 1, 28, 0, 0, 3, 0, 0, 0, 15, 5, 0, 0, 2, 0, 0, 0, 2, 0, 0, 9, 0, 14, 0, 8, 0, 0, 0, 78, 0, 0, 0, 0, 0, 65, 41, 0, 93, 0, 6, 0, 0, 20, 6, 0, 0, 2, 0, 0, 20, 0, 0, 42, 1, 0, 5, 43, 0, 5, 0, 0, 100, 0, 0, 1, 0, 45, 0, 6, 4, 0, 63, 0, 0, 0, 1, 0, 2, 0, 0, 1, 0, 236, 0, 0, 0, 18, 34, 0, 0, 0, 4, 0, 3, 0, 0, 0, 0, 0, 21, 35, 54, 0, 0, 0, 1, 35, 0, 0, 31, 30, 1, 2, 6, 6, 0, 9, 0, 0, 0, 19, 0, 0, 0, 0, 35, 73, 0, 0, 0, 0, 82, 17, 0, 0, 0, 44, 0, 0, 69, 1, 136, 0, 0, 0, 0, 0, 0, 0, 0, 28, 0, 0, 0, 48, 0, 0, 10, 2, 0, 2, 0, 0, 1, 0, 0, 0, 0, 0, 7, 15, 0, 0, 0, 20, 0, 2, 11, 49, 0, 0, 0, 0, 0, 0, 16, 0, 0, 0, 0, 0, 0, 0, 177, 0, 0, 0, 0, 17, 0, 0, 35, 0, 0, 7, 1, 8, 0, 4, 0, 18, 7, 0, 36, 1, 0, 1, 0, 2, 1, 0, 70, 35, 0, 0, 0, 0, 0, 0, 0, 0, 0, 12, 0, 277, 0, 0, 0, 3, 0, 0, 0, 0, 9, 0, 0, 95, 3, 0, 23, 0, 0, 1, 14, 0, 36, 0, 9, 61, 0, 1, 1, 0, 6, 0, 0, 0, 0, 0, 0, 0, 1, 21, 22, 12, 7, 0, 2, 0, 0, 92, 21, 0, 0, 0, 2, 87, 0, 0, 0, 0, 0, 0, 5, 0, 0, 5, 5, 0, 0, 0, 0, 0, 0, 1, 28, 17, 1, 0, 0, 3, 6, 0, 3, 59, 28, 0, 4, 0, 0, 4, 0, 2, 2, 0, 33, 5, 12, 0, 0, 0, 0, 0, 0, 0, 0, 0, 0, 74, 0, 0, 0, 0, 2, 0, 0, 0, 0, 0, 0, 81, 0, 0, 0, 0, 0, 0, 1, 0, 12, 0, 0, 0, 1, 2, 0, 0, 60, 0, 0, 0, 0, 0, 0, 0, 5, 0, 0, 0, 3, 0, 0, 64, 0, 0, 2, 0, 0, 4, 0, 0, 0, 0, 0, 0, 0, 0, 0, 6, 59, 0, 0, 0, 114, 0, 0, 0, 5, 0, 0, 1, 56, 0, 0, 17, 17, 0, 0, 100, 0, 48, 2, 0, 0, 0, 0, 0, 0, 0, 0, 0, 0, 5, 15, 7, 0, 0, 0, 2, 0, 1, 0, 1, 23, 88, 0, 1, 0, 25, 1, 9, 2, 4, 0, 19, 0, 0, 0, 0, 2, 0, 0, 0, 8, 0, 53, 0, 0, 0, 0, 0, 0, 0, 0, 0, 0, 0, 88, 0, 0, 52, 10, 0, 0, 85, 0, 2, 0, 4, 2, 76, 0, 0, 0, 0, 0, 0, 37, 0, 0, 0, 69, 0, 0, 0, 0, 0, 25, 0, 0, 0, 0, 9, 132, 0, 0, 2, 0, 1, 235, 0, 6, 2, 0, 3, 383, 8, 0, 0, 12, 18, 0, 0, 0, 6, 21, 30, 0, 73, 0, 0, 0, 106, 14, 0, 0, 0, 0, 39, 57, 14, 35, 0, 0, 0, 0, 8, 35, 0, 2, 13, 48, 4, 0, 0, 0, 16, 0, 6, 75, 73, 2, 0, 0, 0, 0, 0, 62, 63, 6, 0, 0, 0, 16, 0, 0, 0, 21, 0, 0, 0, 0, 0, 0, 0, 0, 0, 14, 7, 0, 0, 4, 0, 0, 0, 1, 247, 0, 0, 0, 0, 0, 0, 0, 0, 0, 0, 0, 72, 0, 0, 29, 0, 5, 0, 10, 0, 0, 20, 0, 28, 4, 64, 0, 0, 0, 0, 0, 0, 0, 4, 0, 0, 0, 0, 1, 30, 66, 0, 29, 2, 100, 0, 24, 0, 0, 0, 0, 10, 0, 3, 0, 0, 0, 1, 7, 2, 0, 0, 17, 0, 0, 0, 1, 8, 0, 0, 0, 0, 5, 0, 0, 0, 1, 10, 3, 78, 53, 0, 0, 0, 0, 0, 1, 0, 24, 0, 0, 0, 17, 2, 0, 0, 0, 0, 0, 0, 0, 2, 0, 0, 64, 0, 0, 0, 0, 0, 0, 0, 1, 0, 0, 0, 107, 18, 0, 0, 18, 22, 0, 0, 0, 1, 1, 1048, 0, 0, 746, 29, 0, 37, 0, 0, 1, 0, 0, 0, 27, 29, 21, 0, 4, 0, 0, 2, 0, 0, 37, 0, 0, 0, 16, 0, 0, 20, 45, 0, 0, 0, 0, 3, 1, 0, 0, 1, 0, 6, 0, 1, 0, 0, 0, 0, 0, 0, 0, 89, 0, 0, 0, 55, 1, 63, 0, 0, 14, 2, 0, 0, 36, 4, 0, 0, 0, 2, 0, 0, 0, 1, 0, 3, 0, 45, 0, 13, 1, 0, 1, 12, 0, 0, 0, 1, 0, 17, 0, 6, 0, 120, 0, 2, 0, 4, 90, 0, 0, 0, 0, 0, 0, 0, 0, 3, 187, 0, 0, 14, 0, 0, 32, 10, 14, 3, 0, 0, 2, 7, 0, 15, 0, 2, 0, 0, 0, 2, 0, 26, 0, 0, 0, 0, 8, 0, 0, 0, 56, 14, 3, 0, 0, 2, 0, 38, 0, 0, 0, 0, 0, 0, 0, 0, 0, 2, 1, 22, 1, 0, 0, 2, 5, 97, 0, 29, 0, 4, 0, 23, 3, 0, 0, 28, 0, 0, 0, 7, 2, 0, 0, 0, 1, 0, 1, 0, 250, 14, 23, 0, 0, 0, 0, 57, 215, 0, 0, 4, 0, 0, 1, 58, 1, 0, 11, 0, 0, 0, 1, 0, 34, 0, 0, 0, 6, 0, 0, 0, 1, 0, 0, 0, 0, 21, 0, 0, 0, 4, 0, 0, 0, 0, 0, 0, 19, 0, 0, 59, 1, 9, 0, 4, 0, 2, 0, 0, 1, 0, 2, 0, 0, 0, 0, 4, 0, 0, 0, 0, 0, 1, 1, 3, 0, 6, 2, 1, 0, 10, 0, 0, 0, 24, 14, 37, 0, 1, 6, 4, 0, 0, 0, 0, 0, 74, 2, 0, 0, 1, 0, 0, 0, 0, 9, 0, 7, 0, 0, 0, 7, 2, 1, 1, 0, 0, 6, 0, 0, 10, 2, 12, 74, 0, 0, 37, 60, 0, 0, 32, 0, 0, 0, 0, 3, 0, 0, 0, 2, 2, 0, 0, 3, 0, 27, 21, 0, 0, 0, 4, 4, 0, 32, 1, 1, 0, 0, 0, 0, 0, 0, 43, 0, 69, 7, 0, 0, 0, 0, 2, 0, 0, 37, 0, 21, 0, 0, 0, 0, 21, 0, 35, 0, 0, 0, 125, 0, 0, 0, 0, 7, 3, 0, 0, 18, 0, 0, 8, 0, 0, 0, 0, 13, 72, 0, 10, 1, 37, 2, 18, 3, 1, 0, 5, 0, 0, 0, 37, 11, 0, 4, 0, 0, 6, 0, 0, 0, 0, 14, 12, 1, 3, 22, 0, 0, 2, 19, 45, 0, 37, 0, 0, 0, 0, 0, 0, 0, 15, 0, 15, 124, 16, 0
Last-man-standing-the-ascent-of-Jamie-Dimon-and-JPMorgan-Chase-by-J.P.-Morgan-ChaseCo, 0, 0, 0, 22, 51, 0, 0, 0, 14, 28, 2, 21, 0, 0, 0, 0, 2, 0, 0, 0, 0, 0, 0, 5, 0, 0, 0, 0, 2, 1, 0, 0, 0, 0, 0, 0, 0, 0, 90, 0, 56, 0, 12, 0, 0, 0, 58, 40, 1, 0, 0, 22, 0, 0, 1757, 0, 0, 0, 0, 0, 35, 0, 0, 26, 105, 0, 0, 13, 3, 2, 0, 0, 0, 0, 0, 0, 0, 0, 22, 0, 0, 0, 0, 0, 0, 153, 0, 1, 0, 106, 0, 0, 8, 0, 0, 0, 1, 0, 2, 5, 39, 0, 0, 0, 1, 0, 0, 0, 41, 0, 0, 21, 1, 0, 0, 33, 0, 4, 0, 0, 0, 0, 1, 0, 2, 184, 0, 0, 0, 0, 23, 0, 0, 18, 0, 0, 0, 0, 0, 0, 0, 0, 0, 5, 0, 5, 42, 0, 0, 0, 0, 0, 4, 0, 15, 36, 1, 0, 54, 19, 0, 30, 0, 0, 0, 0, 10, 1, 4, 4, 0, 22, 19, 44, 6, 0, 0, 0, 26, 70, 0, 6, 0, 40, 0, 0, 0, 12, 0, 18, 0, 0, 0, 1, 190, 0, 0, 3, 14, 0, 0, 383, 0, 27, 1, 0, 1, 0, 246, 1, 9, 20, 0, 0, 4, 0, 3, 0, 0, 43, 0, 0, 0, 0, 2, 0, 0, 0, 0, 0, 112, 0, 0, 0, 0, 0, 0, 0, 0, 0, 0, 5, 1, 2, 1, 0, 0, 0, 2, 0, 31, 0, 0, 0, 143, 0, 53, 0, 48, 0, 0, 4, 28, 2, 0, 0, 0, 0, 0, 9, 5, 0, 39, 0, 60, 51, 1, 0, 1, 0, 10, 0, 0, 0, 10, 0, 0, 0, 0, 6, 0, 13, 3, 0, 2, 2, 0, 19, 0, 10, 3, 23, 0, 0, 0, 40, 20, 0, 0, 0, 15, 0, 0, 0, 1, 32, 0, 15, 0, 1, 10, 0, 0, 4, 14, 0, 0, 0, 48, 0, 0, 8, 0, 8, 2, 0, 0, 0, 0, 0, 0, 0, 0, 0, 0, 0, 54, 44, 0, 3, 0, 45, 0, 0, 39, 0, 0, 129, 0, 0, 14, 0, 1, 0, 0, 0, 6, 0, 4, 0, 0, 0, 1, 2, 0, 0, 17, 19, 0, 37, 0, 0, 23, 0, 0, 11, 0, 0, 15, 0, 77, 10, 3, 0, 0, 0, 0, 0, 1, 1, 0, 0, 2, 0, 0, 0, 0, 4, 0, 122, 3, 0, 0, 0, 1, 1, 0, 0, 0, 0, 0, 0, 0, 2, 0, 2, 2, 0, 63, 0, 0, 53, 0, 0, 4, 0, 0, 0, 65, 1, 1, 3, 0, 57, 48, 0, 1, 0, 0, 0, 0, 0, 0, 0, 45, 0, 47, 27, 0, 0, 0, 369, 0, 0, 1, 0, 89, 0, 0, 0, 0, 0, 0, 0, 0, 0, 0, 0, 2, 9, 0, 0, 8, 0, 0, 0, 12, 0, 0, 0, 0, 0, 0, 0, 0, 0, 11, 3, 3, 27, 0, 0, 0, 18, 0, 0, 0, 2, 0, 0, 0, 182, 0, 0, 66, 64, 0, 1, 7, 0, 0, 0, 15, 0, 0, 32, 0, 0, 0, 9, 13, 0, 0, 1, 0, 2, 2, 4, 0, 1, 21, 4, 0, 3, 87, 0, 0, 1, 0, 0, 0, 0, 1, 0, 0, 0, 65, 0, 0, 7, 11, 0, 0, 0, 0, 0, 0, 2, 0, 0, 19, 0, 0, 3, 0, 0, 2, 75, 2, 0, 1, 0, 0, 0, 67, 7, 0, 0, 4, 0, 0, 0, 9, 0, 0, 15, 0, 6, 0, 25, 0, 0, 0, 31, 0, 0, 0, 0, 2, 10, 43, 0, 207, 0, 4, 0, 0, 7, 0, 0, 0, 0, 0, 0, 77, 0, 0, 15, 1, 5, 797, 43, 0, 24, 9, 0, 86, 0, 0, 46, 0, 36, 0, 6, 8, 0, 42, 0, 0, 0, 0, 0, 4, 0, 9, 2, 0, 234, 1, 0, 0, 27, 37, 0, 0, 0, 1, 0, 3, 0, 1, 0, 0, 0, 7, 13, 77, 23, 0, 2, 8, 117, 0, 0, 63, 2, 4, 19, 121, 2, 0, 9, 0, 0, 0, 1, 0, 2, 0, 0, 28, 87, 0, 0, 0, 5, 124, 15, 0, 0, 15, 82, 0, 0, 13, 4, 27, 15, 0, 0, 0, 2, 0, 0, 0, 23, 0, 0, 0, 52, 0, 0, 14, 4, 0, 0, 0, 0, 0, 0, 0, 0, 0, 0, 0, 13, 0, 0, 1, 16, 0, 0, 31, 336, 0, 0, 0, 47, 0, 0, 9, 0, 0, 0, 0, 1, 0, 0, 132, 0, 1, 0, 0, 33, 1, 2, 6, 0, 0, 7, 0, 23, 0, 6, 3, 32, 0, 0, 32, 6, 0, 0, 0, 8, 0, 0, 39, 11, 1, 0, 0, 0, 0, 0, 0, 0, 0, 23, 0, 0, 0, 4, 0, 4, 0, 0, 0, 0, 36, 0, 0, 0, 12, 0, 20, 0, 0, 8, 12, 0, 40, 0, 8, 31, 0, 0, 1, 3, 5, 0, 0, 0, 1, 0, 1, 0, 3, 5, 42, 20, 9, 0, 3, 0, 0, 0, 11, 0, 0, 0, 0, 105, 0, 0, 0, 1, 0, 0, 5, 0, 0, 5, 3, 0, 1, 3, 10, 1, 1, 9, 16, 13, 6, 0, 0, 0, 9, 0, 0, 231, 39, 0, 0, 2, 0, 16, 0, 16, 0, 0, 5, 10, 7, 0, 7, 5, 0, 0, 0, 0, 0, 1, 0, 49, 0, 0, 0, 0, 2, 0, 0, 0, 0, 0, 1, 40, 0, 0, 0, 1, 0, 0, 3, 0, 18, 0, 0, 1, 4, 3, 0, 1, 24, 0, 0, 0, 0, 0, 0, 0, 3, 0, 0, 0, 2, 0, 0, 25, 0, 0, 4, 0, 0, 1, 0, 4, 0, 1, 0, 0, 0, 1, 0, 7, 6, 0, 0, 0, 108, 0, 0, 0, 14, 1, 0, 0, 29, 0, 0, 77, 0, 0, 0, 122, 0, 4, 0, 0, 0, 0, 1, 0, 0, 0, 0, 0, 2, 141, 27, 5, 0, 0, 0, 2, 2, 5, 0, 0, 12, 11, 1, 1, 0, 49, 1, 4, 0, 0, 0, 62, 5, 0, 0, 0, 8, 0, 0, 0, 2, 0, 25, 0, 0, 0, 1, 0, 0, 0, 0, 0, 2, 0, 60, 0, 0, 37, 0, 0, 0, 50, 0, 8, 0, 0, 2, 84, 3, 0, 0, 0, 0, 0, 51, 1, 0, 0, 21, 0, 21, 0, 0, 0, 42, 63, 0, 0, 0, 3, 30, 0, 0, 0, 0, 77, 157, 0, 5, 23, 0, 5, 219, 7, 0, 0, 38, 41, 0, 0, 0, 6, 0, 41, 0, 96, 0, 0, 0, 45, 9, 0, 0, 0, 0, 0, 1, 89, 62, 0, 0, 0, 0, 0, 20, 2, 3, 8, 205, 3, 0, 0, 0, 1, 0, 29, 90, 21, 1, 0, 0, 0, 0, 0, 41, 39, 159, 0, 0, 0, 27, 0, 0, 0, 0, 0, 0, 0, 0, 0, 0, 22, 0, 0, 6, 1, 0, 0, 96, 0, 0, 0, 1, 100, 0, 0, 0, 0, 0, 0, 0, 0, 0, 2, 0, 2, 0, 0, 61, 1, 0, 0, 9, 0, 0, 15, 0, 2, 12, 357, 0, 5, 0, 0, 0, 0, 0, 0, 0, 0, 0, 0, 0, 99, 81, 0, 69, 0, 34, 1, 18, 0, 0, 0, 0, 18, 0, 20, 4, 0, 0, 59, 9, 1, 0, 4, 18, 0, 0, 0, 1, 10, 52, 0, 0, 0, 9, 0, 0, 0, 0, 5, 1, 44, 36, 0, 0, 0, 0, 0, 1, 8, 42, 0, 0, 0, 6, 2, 2, 2, 0, 0, 0, 0, 0, 0, 0, 0, 7, 0, 0, 0, 0, 0, 0, 0, 2, 1, 0, 0, 616, 18, 0, 0, 38, 0, 0, 0, 1, 0, 0, 144, 0, 0, 528, 57, 0, 218, 2, 0, 0, 0, 0, 0, 4, 0, 23, 0, 11, 0, 0, 7, 0, 0, 68, 3, 0, 0, 25, 0, 15, 64, 69, 0, 0, 0, 0, 0, 0, 1, 0, 2, 0, 253, 0, 0, 0, 0, 0, 0, 0, 0, 0, 24, 0, 0, 0, 93, 8, 62, 12, 0, 8, 4, 0, 0, 22, 6, 0, 0, 0, 2, 0, 0, 0, 0, 0, 1, 0, 8, 0, 9, 2, 0, 0, 51, 0, 0, 0, 13, 0, 3, 0, 22, 0, 5, 0, 0, 0, 0, 100, 0, 1, 0, 0, 0, 0, 0, 1, 1, 173, 0, 0, 11, 0, 0, 7, 4, 0, 32, 0, 0, 16, 16, 0, 77, 0, 7, 0, 0, 0, 0, 0, 10, 0, 0, 0, 0, 7, 0, 0, 0, 26, 2, 21, 0, 0, 6, 0, 39, 0, 0, 1, 0, 1, 0, 0, 0, 1, 1, 2, 0, 1, 0, 0, 0, 1, 21, 0, 21, 0, 0, 2, 4, 14, 0, 0, 1, 0, 0, 0, 0, 24, 1, 3, 0, 0, 0, 3, 0, 280, 21, 0, 0, 0, 0, 0, 85, 101, 0, 0, 1, 1, 1, 0, 0, 0, 0, 27, 0, 0, 1, 57, 0, 56, 0, 0, 0, 28, 0, 0, 0, 0, 0, 0, 0, 0, 30, 0, 0, 0, 18, 0, 0, 0, 0, 0, 0, 35, 0, 0, 37, 3, 4, 0, 0, 0, 0, 0, 0, 0, 0, 0, 0, 0, 0, 1, 4, 0, 0, 0, 0, 0, 1, 0, 2, 17, 11, 4, 0, 0, 69, 0, 0, 0, 45, 8, 62, 0, 0, 34, 7, 0, 0, 5, 0, 0, 104, 2, 0, 0, 0, 0, 0, 0, 0, 29, 0, 1, 0, 0, 0, 16, 0, 12, 0, 0, 0, 7, 0, 0, 4, 2, 39, 97, 0, 0, 82, 67, 0, 0, 56, 0, 0, 0, 8, 18, 2, 0, 0, 1, 2, 0, 5, 116, 0, 40, 9, 0, 0, 0, 6, 0, 0, 33, 0, 45, 0, 0, 0, 0, 0, 2, 84, 0, 195, 49, 0, 0, 0, 1, 3, 0, 0, 23, 0, 0, 0, 0, 0, 0, 21, 0, 23, 0, 0, 0, 28, 0, 0, 0, 0, 2, 20, 0, 0, 7, 0, 0, 15, 0, 0, 0, 4, 12, 57, 0, 3, 1, 1, 2, 0, 0, 0, 0, 0, 0, 0, 0, 60, 15, 0, 5, 0, 51, 0, 8, 0, 0, 0, 8, 46, 0, 0, 78, 0, 0, 0, 22, 62, 0, 16, 0, 0, 0, 0, 0, 0, 0, 11, 0, 31, 94, 10, 2
Lights Out - Pride- Delusion and the Fall of General Electric by Thomas Gryta - Ted Mann (z-lib.org).epub, 0, 0, 0, 31, 43, 0, 0, 0, 0, 70, 6, 13, 0, 0, 0, 0, 5, 0, 0, 0, 0, 0, 0, 13, 0, 0, 0, 0, 1, 2, 0, 0, 0, 0, 0, 0, 0, 14, 34, 0, 7, 0, 5, 0, 0, 0, 0, 51, 1, 0, 0, 77, 0, 0, 0, 0, 0, 0, 0, 0, 95, 0, 71, 0, 37, 0, 0, 24, 0, 1, 0, 0, 0, 0, 0, 0, 0, 0, 29, 0, 51, 0, 0, 0, 0, 7, 0, 0, 0, 206, 0, 0, 5, 0, 0, 0, 0, 0, 6, 17, 7, 0, 0, 0, 0, 0, 0, 0, 22, 0, 0, 14, 0, 0, 0, 15, 0, 3, 7, 0, 0, 0, 0, 0, 12, 129, 3, 0, 0, 0, 9, 0, 2, 0, 0, 0, 2, 0, 0, 6, 30, 0, 0, 0, 0, 16, 87, 0, 0, 0, 0, 0, 0, 0, 26, 126, 76, 0, 40, 9, 0, 29, 0, 0, 4, 0, 0, 3, 23, 9, 0, 0, 3, 23, 7, 0, 4, 0, 13, 28, 0, 26, 0, 40, 0, 0, 0, 9, 0, 38, 0, 0, 4, 5, 47, 0, 0, 2, 23, 0, 0, 21, 0, 64, 0, 0, 1, 0, 6, 21, 13, 52, 10, 0, 8, 0, 1, 0, 0, 11, 0, 0, 0, 0, 0, 0, 0, 0, 1, 0, 4, 0, 0, 0, 0, 0, 14, 0, 1, 0, 0, 4, 8, 1, 1, 141, 0, 0, 0, 0, 38, 0, 0, 0, 157, 0, 35, 0, 0, 0, 0, 5, 6, 0, 0, 0, 3, 0, 0, 16, 2, 0, 76, 3, 26, 15, 5, 0, 0, 0, 15, 0, 0, 0, 4, 0, 0, 0, 0, 29, 0, 9, 14, 1, 2, 22, 0, 74, 0, 18, 0, 26, 0, 0, 0, 31, 20, 0, 0, 31, 13, 0, 0, 0, 0, 15, 0, 2, 0, 0, 12, 0, 0, 10, 0, 0, 0, 0, 48, 0, 0, 20, 0, 5, 1, 0, 0, 0, 0, 0, 4, 0, 0, 0, 0, 0, 64, 3, 0, 1, 0, 23, 1, 0, 45, 0, 0, 194, 0, 0, 9, 0, 8, 1, 0, 0, 5, 0, 17, 0, 0, 0, 2, 5, 0, 0, 21, 33, 0, 110, 0, 0, 14, 3, 0, 34, 0, 0, 6, 0, 41, 12, 0, 1, 0, 0, 0, 3, 0, 0, 0, 0, 0, 0, 0, 0, 0, 1, 0, 45, 22, 0, 0, 2, 1, 0, 0, 0, 0, 0, 0, 0, 0, 0, 0, 42, 0, 0, 49, 0, 0, 19, 0, 0, 2, 0, 11, 1, 15, 3, 0, 10, 0, 1, 31, 0, 0, 0, 0, 0, 0, 4, 0, 1, 23, 0, 37, 24, 0, 0, 0, 213, 0, 1, 6, 0, 35, 0, 0, 2, 0, 0, 0, 0, 0, 0, 1, 0, 0, 4, 0, 0, 1, 0, 0, 0, 28, 1, 2, 0, 0, 0, 0, 0, 0, 0, 2, 25, 28, 7, 0, 1, 0, 26, 0, 0, 0, 0, 0, 0, 0, 4, 1, 0, 41, 55, 0, 12, 1, 0, 0, 2, 11, 0, 0, 107, 0, 2, 0, 7, 15, 0, 0, 1, 0, 1, 4, 8, 0, 0, 14, 11, 0, 2, 0, 0, 0, 0, 0, 0, 0, 1, 62, 0, 0, 0, 112, 0, 0, 15, 22, 0, 0, 0, 0, 0, 0, 3, 0, 0, 10, 0, 0, 1, 0, 0, 1, 35, 0, 0, 1, 2, 0, 0, 6, 1, 0, 0, 0, 0, 0, 0, 18, 0, 0, 7, 0, 11, 0, 6, 0, 0, 2, 43, 0, 0, 29, 0, 0, 1, 31, 1, 98, 0, 7, 0, 0, 23, 1, 0, 0, 4, 0, 0, 36, 0, 0, 27, 0, 8, 0, 20, 0, 9, 0, 0, 133, 0, 0, 5, 0, 55, 0, 0, 11, 0, 63, 0, 0, 0, 3, 0, 9, 0, 3, 1, 0, 46, 0, 0, 0, 0, 31, 0, 1, 0, 1, 0, 2, 0, 0, 0, 0, 0, 14, 48, 10, 0, 0, 0, 0, 119, 0, 0, 24, 8, 323, 0, 25, 1, 0, 34, 0, 0, 4, 3, 0, 0, 0, 20, 80, 21, 0, 0, 0, 896, 139, 9, 0, 0, 0, 26, 36, 0, 28, 2, 27, 0, 0, 0, 0, 2, 0, 0, 0, 12, 1, 0, 0, 132, 0, 0, 24, 27, 0, 0, 0, 0, 0, 0, 0, 0, 0, 0, 0, 9, 3, 0, 0, 44, 0, 0, 77, 19, 0, 0, 0, 13, 0, 0, 2, 0, 0, 0, 0, 0, 0, 0, 86, 0, 0, 0, 57, 68, 0, 4, 34, 0, 0, 3, 21, 3, 0, 11, 0, 216, 8, 0, 28, 10, 0, 5, 0, 0, 0, 0, 44, 0, 2, 0, 0, 0, 0, 0, 0, 0, 0, 21, 0, 0, 0, 3, 0, 8, 0, 0, 0, 0, 28, 0, 0, 0, 12, 0, 8, 0, 0, 4, 27, 0, 149, 0, 4, 126, 0, 0, 0, 1, 0, 3, 0, 0, 0, 0, 1, 0, 3, 1, 32, 11, 21, 0, 11, 0, 0, 0, 5, 0, 0, 0, 0, 89, 0, 0, 0, 0, 3, 0, 0, 0, 0, 18, 0, 1, 0, 0, 1, 7, 1, 0, 0, 42, 15, 0, 0, 1, 7, 0, 2, 107, 29, 0, 0, 0, 0, 11, 0, 14, 0, 0, 1, 8, 17, 1, 2, 9, 0, 0, 0, 0, 0, 1, 0, 54, 0, 0, 0, 0, 4, 0, 0, 0, 0, 0, 0, 76, 0, 1, 0, 0, 0, 0, 0, 0, 12, 0, 0, 0, 3, 10, 0, 1, 65, 0, 0, 1, 0, 0, 0, 0, 2, 0, 0, 0, 10, 0, 0, 27, 1, 0, 15, 0, 0, 1, 0, 13, 0, 0, 0, 0, 0, 2, 0, 0, 10, 2, 0, 0, 301, 0, 2, 0, 8, 0, 0, 0, 37, 0, 0, 37, 0, 0, 0, 139, 0, 33, 0, 0, 0, 0, 0, 0, 0, 0, 0, 0, 0, 13, 26, 1, 0, 0, 0, 2, 7, 2, 0, 10, 20, 9, 1, 2, 0, 19, 0, 0, 0, 5, 0, 30, 45, 21, 0, 2, 4, 0, 0, 0, 6, 0, 36, 0, 0, 0, 1, 0, 0, 0, 0, 0, 2, 0, 112, 0, 0, 81, 0, 0, 0, 15, 0, 9, 0, 1, 1, 87, 0, 0, 0, 0, 0, 0, 66, 0, 0, 95, 25, 0, 16, 0, 0, 0, 2, 0, 0, 0, 0, 0, 28, 0, 0, 0, 0, 0, 215, 0, 16, 0, 0, 3, 206, 55, 0, 0, 33, 15, 4, 0, 0, 4, 0, 26, 0, 59, 0, 0, 0, 10, 18, 0, 0, 0, 0, 0, 0, 35, 85, 0, 0, 0, 0, 3, 30, 2, 75, 2, 232, 6, 0, 0, 0, 17, 0, 19, 262, 12, 0, 0, 0, 0, 0, 0, 20, 34, 4, 0, 0, 0, 6, 0, 0, 0, 0, 0, 0, 0, 0, 0, 0, 0, 0, 0, 4, 11, 0, 0, 8, 0, 0, 0, 4, 86, 0, 8, 0, 0, 1, 0, 0, 0, 0, 2, 1, 12, 0, 0, 62, 7, 0, 0, 23, 0, 0, 45, 2, 2, 32, 323, 0, 0, 0, 0, 0, 0, 0, 0, 0, 0, 0, 0, 6, 60, 11, 0, 51, 6, 28, 0, 0, 0, 0, 0, 4, 2, 0, 37, 1, 0, 0, 0, 4, 1, 0, 0, 21, 0, 0, 0, 2, 2, 0, 1, 0, 0, 4, 0, 25, 0, 2, 2, 0, 19, 81, 0, 0, 0, 0, 0, 0, 0, 55, 0, 0, 0, 4, 6, 1, 2, 0, 8, 4, 0, 0, 5, 0, 0, 82, 0, 0, 0, 0, 1, 0, 0, 1, 0, 0, 0, 977, 25, 0, 0, 35, 0, 0, 0, 1, 5, 3, 11, 0, 0, 97, 2, 0, 81, 7, 0, 2, 0, 2, 0, 0, 0, 17, 5, 0, 0, 0, 1, 0, 0, 51, 1, 0, 0, 27, 4, 8, 55, 24, 0, 0, 0, 0, 0, 0, 0, 0, 1, 0, 3, 0, 23, 0, 0, 3, 0, 0, 0, 0, 39, 0, 0, 1, 79, 10, 33, 1, 0, 7, 0, 0, 0, 77, 17, 0, 0, 0, 1, 0, 0, 1, 0, 0, 0, 0, 23, 0, 7, 8, 3, 0, 50, 0, 0, 0, 0, 0, 11, 0, 11, 0, 8, 0, 2, 0, 5, 85, 0, 0, 0, 0, 0, 0, 0, 0, 6, 57, 0, 0, 13, 0, 0, 9, 13, 1, 25, 0, 0, 3, 12, 0, 77, 0, 0, 228, 0, 0, 1, 0, 10, 0, 0, 0, 1, 20, 1, 0, 0, 63, 156, 1, 0, 0, 9, 0, 81, 0, 0, 0, 0, 2, 0, 0, 0, 0, 0, 1, 4, 3, 0, 0, 0, 2, 36, 0, 19, 0, 0, 1, 28, 8, 0, 0, 0, 0, 0, 0, 0, 24, 8, 9, 0, 0, 0, 3, 0, 520, 24, 7, 0, 0, 0, 0, 0, 10, 0, 0, 1, 1, 0, 10, 0, 0, 0, 3, 0, 0, 3, 0, 0, 29, 0, 0, 0, 8, 0, 0, 0, 0, 0, 0, 0, 0, 26, 1, 0, 0, 4, 0, 0, 0, 0, 0, 0, 10, 0, 0, 24, 1, 8, 0, 0, 0, 1, 0, 0, 6, 0, 0, 0, 0, 0, 4, 11, 0, 0, 0, 7, 0, 7, 0, 1, 9, 7, 9, 2, 0, 16, 0, 0, 0, 15, 18, 46, 0, 1, 0, 6, 0, 0, 4, 0, 0, 51, 0, 0, 0, 0, 0, 0, 0, 0, 122, 0, 45, 0, 0, 0, 18, 0, 1, 0, 0, 0, 1, 6, 0, 4, 0, 59, 90, 0, 0, 111, 46, 0, 0, 6, 0, 0, 5, 0, 9, 1, 0, 9, 0, 7, 0, 2, 0, 0, 13, 20, 0, 0, 0, 22, 1, 0, 62, 0, 18, 0, 0, 0, 0, 0, 0, 81, 1, 94, 23, 0, 0, 0, 0, 0, 0, 0, 11, 1, 0, 0, 0, 0, 0, 34, 0, 30, 0, 0, 0, 6, 0, 0, 0, 3, 7, 7, 0, 0, 22, 3, 0, 33, 2, 0, 0, 0, 35, 128, 1, 11, 1, 4, 72, 0, 1, 2, 0, 4, 0, 0, 7, 0, 9, 2, 4, 0, 0, 2, 2, 0, 0, 1, 18, 15, 0, 3, 60, 0, 0, 0, 35, 18, 0, 17, 0, 2, 0, 0, 0, 0, 0, 1, 0, 11, 64, 24, 0
Mauro F. Guillen- Adrian Tschoegl - Building a Global Bank_ The Transformation of Banco Santander (2008) - libgen.lc, 0, 0, 0, 38, 20, 0, 0, 1, 0, 30, 0, 0, 0, 0, 0, 2, 8, 0, 0, 0, 0, 1, 0, 35, 3, 0, 0, 0, 4, 4, 0, 0, 0, 21, 29, 0, 0, 0, 36, 0, 4, 0, 24, 0, 0, 0, 0, 162, 0, 0, 0, 87, 0, 1, 0, 0, 0, 0, 0, 0, 15, 1, 0, 0, 37, 0, 0, 110, 0, 0, 0, 0, 0, 0, 0, 0, 0, 0, 11, 0, 0, 0, 0, 0, 0, 0, 0, 0, 0, 108, 0, 0, 0, 0, 0, 0, 0, 4, 1, 0, 7, 0, 0, 0, 0, 0, 0, 0, 9, 0, 0, 13, 0, 0, 0, 14, 0, 0, 0, 0, 0, 0, 0, 0, 2, 29, 0, 0, 0, 0, 0, 0, 0, 0, 0, 0, 0, 0, 0, 2, 0, 0, 105, 0, 0, 3, 21, 0, 0, 0, 1, 0, 0, 0, 0, 4, 1, 0, 44, 5, 0, 11, 3, 0, 2, 0, 3, 6, 18, 22, 0, 0, 0, 35, 0, 0, 0, 0, 65, 4, 0, 1, 0, 24, 0, 0, 0, 0, 0, 23, 0, 0, 0, 0, 52, 0, 0, 1, 14, 0, 0, 15, 0, 66, 0, 0, 1, 0, 0, 13, 11, 2, 0, 0, 0, 0, 0, 0, 0, 12, 0, 0, 0, 0, 2, 0, 0, 0, 0, 0, 0, 0, 0, 0, 0, 0, 3, 0, 0, 0, 0, 7, 11, 0, 0, 0, 0, 1, 0, 0, 17, 0, 0, 0, 39, 0, 24, 0, 0, 0, 0, 0, 0, 0, 0, 0, 0, 0, 6, 3, 10, 0, 35, 3, 15, 0, 0, 0, 0, 0, 1, 0, 0, 0, 5, 0, 0, 0, 0, 6, 0, 9, 1, 0, 5, 0, 0, 25, 1, 16, 0, 24, 3, 0, 0, 170, 25, 0, 1, 2, 24, 0, 0, 0, 1, 17, 0, 3, 0, 0, 0, 0, 0, 10, 0, 0, 0, 0, 18, 0, 0, 7, 0, 3, 1, 0, 0, 0, 0, 0, 0, 0, 0, 0, 0, 0, 57, 0, 0, 12, 0, 9, 0, 0, 33, 0, 0, 84, 0, 0, 4, 0, 1, 0, 0, 0, 15, 235, 34, 1, 0, 0, 0, 5, 0, 0, 59, 4, 0, 14, 0, 0, 0, 0, 0, 10, 0, 0, 15, 111, 38, 6, 0, 0, 0, 0, 0, 0, 0, 0, 0, 0, 0, 0, 0, 0, 0, 9, 0, 14, 2, 0, 0, 0, 7, 0, 2, 0, 0, 7, 0, 0, 0, 0, 0, 0, 0, 0, 6, 0, 0, 0, 87, 1, 0, 0, 0, 0, 4, 0, 0, 47, 0, 0, 10, 0, 0, 0, 0, 0, 0, 0, 0, 0, 0, 0, 45, 10, 0, 0, 0, 134, 0, 0, 2, 0, 4, 0, 0, 0, 0, 0, 0, 0, 0, 0, 0, 0, 0, 2, 0, 0, 12, 0, 0, 0, 0, 0, 0, 0, 0, 0, 0, 0, 0, 0, 1, 2, 1, 21, 0, 0, 0, 3, 0, 0, 0, 0, 0, 0, 0, 0, 2, 0, 61, 5, 0, 1, 7, 0, 0, 0, 3, 0, 0, 74, 1, 0, 0, 5, 2, 0, 0, 0, 0, 0, 0, 11, 0, 0, 0, 25, 0, 0, 0, 0, 0, 0, 0, 0, 0, 3, 2, 0, 0, 0, 39, 0, 18, 12, 11, 0, 0, 0, 0, 0, 0, 2, 0, 0, 21, 0, 0, 0, 0, 0, 0, 47, 0, 0, 4, 0, 0, 0, 0, 0, 0, 0, 0, 0, 3, 17, 2, 0, 0, 12, 1, 0, 0, 19, 0, 0, 0, 27, 0, 0, 0, 0, 4, 13, 159, 0, 23, 0, 3, 0, 0, 12, 2, 0, 0, 10, 1, 0, 7, 149, 0, 24, 2, 1, 1, 22, 0, 1, 0, 0, 33, 0, 0, 0, 0, 46, 0, 0, 35, 0, 59, 1, 0, 0, 0, 0, 6, 40, 0, 0, 0, 3, 0, 7, 0, 0, 27, 0, 6, 0, 8, 0, 1, 0, 0, 0, 0, 0, 62, 21, 1, 0, 0, 0, 0, 11, 0, 0, 1, 8, 0, 0, 4, 4, 0, 3, 0, 0, 3, 8, 14, 0, 5, 0, 57, 53, 0, 0, 0, 0, 8, 12, 0, 0, 0, 96, 0, 0, 14, 0, 44, 0, 0, 0, 0, 2, 0, 0, 0, 42, 0, 0, 0, 7, 0, 0, 6, 4, 0, 0, 0, 0, 0, 0, 0, 0, 0, 0, 0, 19, 0, 0, 0, 4, 0, 5, 5, 0, 0, 0, 0, 0, 0, 0, 0, 0, 0, 0, 0, 0, 0, 0, 28, 0, 1, 0, 0, 10, 0, 1, 18, 0, 0, 12, 3, 1, 0, 0, 0, 29, 13, 0, 16, 15, 0, 0, 1, 1, 0, 0, 59, 0, 0, 86, 0, 0, 0, 13, 0, 0, 0, 16, 0, 0, 0, 0, 0, 0, 0, 0, 0, 0, 1, 0, 0, 0, 6, 0, 9, 0, 0, 0, 2, 0, 0, 0, 26, 3, 0, 0, 0, 0, 0, 0, 0, 0, 0, 0, 2, 0, 0, 6, 45, 12, 6, 0, 1, 0, 22, 0, 2, 0, 0, 0, 0, 54, 0, 0, 0, 0, 5, 0, 0, 0, 0, 3, 4, 0, 0, 0, 0, 0, 0, 14, 1, 16, 0, 0, 0, 20, 0, 0, 0, 20, 34, 0, 23, 0, 0, 10, 0, 4, 0, 0, 146, 5, 12, 0, 0, 3, 0, 0, 0, 0, 0, 0, 0, 112, 60, 0, 0, 0, 0, 0, 0, 1, 0, 92, 1, 46, 0, 5, 0, 0, 0, 0, 3, 0, 70, 0, 9, 1, 0, 1, 0, 0, 93, 0, 0, 0, 0, 0, 0, 0, 0, 0, 0, 0, 1, 36, 0, 10, 0, 0, 41, 0, 0, 0, 0, 1, 0, 0, 0, 0, 0, 0, 4, 0, 125, 0, 0, 0, 90, 0, 0, 0, 31, 0, 0, 0, 51, 0, 0, 16, 0, 0, 0, 154, 0, 42, 0, 0, 0, 0, 0, 0, 0, 0, 0, 0, 0, 0, 14, 2, 0, 0, 0, 8, 0, 0, 0, 0, 10, 0, 1, 0, 0, 208, 0, 0, 0, 0, 0, 13, 9, 0, 0, 0, 2, 0, 0, 0, 0, 0, 27, 0, 0, 0, 0, 0, 0, 0, 0, 0, 0, 0, 54, 0, 0, 20, 11, 4, 0, 8, 0, 0, 0, 1, 2, 50, 0, 0, 13, 0, 0, 0, 19, 0, 0, 0, 44, 0, 5, 0, 0, 0, 104, 0, 0, 0, 0, 0, 32, 0, 0, 0, 0, 0, 52, 0, 7, 0, 0, 7, 290, 15, 0, 0, 10, 19, 0, 0, 0, 1, 0, 33, 0, 0, 0, 0, 0, 7, 19, 0, 0, 0, 0, 0, 0, 13, 13, 0, 0, 1, 0, 0, 16, 0, 1, 11, 79, 0, 0, 0, 0, 2, 0, 2, 17, 37, 0, 0, 0, 0, 0, 0, 0, 50, 8, 0, 1, 1, 7, 0, 0, 0, 0, 0, 0, 0, 0, 4, 0, 0, 0, 0, 0, 12, 1, 0, 0, 0, 0, 0, 2, 70, 0, 6, 0, 0, 0, 0, 0, 0, 0, 0, 0, 18, 0, 0, 26, 3, 0, 0, 1, 0, 0, 24, 0, 2, 8, 55, 0, 0, 0, 0, 0, 0, 0, 3, 7, 0, 0, 3, 0, 47, 121, 0, 10, 0, 15, 0, 0, 0, 0, 0, 4, 2, 0, 7, 0, 0, 0, 0, 4, 0, 0, 0, 6, 0, 0, 0, 1, 38, 0, 0, 0, 0, 1, 1, 0, 0, 1, 13, 0, 6, 52, 0, 0, 0, 0, 0, 0, 0, 16, 0, 0, 0, 5, 1, 0, 0, 0, 0, 0, 0, 0, 0, 0, 0, 12, 0, 0, 0, 0, 0, 0, 0, 1, 0, 0, 0, 136, 23, 0, 0, 17, 0, 1, 0, 0, 1, 0, 12, 0, 0, 1185, 0, 0, 0, 0, 0, 0, 0, 0, 0, 9, 0, 12, 0, 0, 2, 0, 0, 0, 0, 33, 0, 0, 0, 16, 0, 0, 47, 2, 0, 0, 0, 0, 0, 0, 0, 0, 0, 0, 0, 0, 0, 0, 0, 0, 0, 0, 0, 0, 68, 0, 0, 0, 6, 6, 3, 2, 0, 10, 1, 140, 0, 15, 3, 0, 0, 0, 3, 0, 0, 0, 0, 0, 1, 0, 34, 0, 9, 2, 0, 1, 117, 0, 0, 0, 0, 0, 77, 0, 17, 0, 80, 0, 42, 0, 10, 72, 0, 0, 0, 0, 0, 0, 1, 0, 11, 94, 0, 0, 22, 2, 0, 84, 7, 52, 53, 0, 0, 0, 4, 0, 20, 0, 0, 0, 0, 0, 0, 0, 38, 0, 0, 0, 0, 11, 0, 0, 0, 58, 77, 0, 0, 0, 3, 0, 49, 3, 0, 0, 0, 0, 0, 0, 0, 0, 170, 0, 0, 2, 0, 0, 0, 0, 53, 0, 9, 0, 0, 1, 92, 2, 0, 0, 58, 0, 0, 1, 0, 0, 0, 4, 1, 0, 0, 0, 0, 67, 59, 14, 0, 0, 0, 0, 0, 331, 0, 0, 0, 16, 0, 0, 0, 9, 0, 3, 0, 0, 0, 0, 0, 17, 0, 0, 0, 6, 53, 0, 0, 2, 0, 0, 9, 0, 5, 0, 0, 0, 0, 0, 0, 0, 0, 2, 0, 4, 0, 0, 8, 0, 2, 0, 0, 0, 5, 1, 4, 0, 1, 0, 3, 0, 0, 0, 9, 0, 0, 0, 0, 0, 0, 2, 7, 0, 28, 2, 0, 0, 3, 0, 0, 0, 29, 13, 15, 0, 0, 1, 0, 0, 0, 0, 0, 0, 33, 0, 0, 0, 0, 0, 0, 0, 0, 10, 0, 6, 0, 0, 0, 1, 3, 1, 0, 0, 0, 0, 0, 0, 1, 0, 30, 15, 0, 0, 56, 72, 0, 0, 2, 0, 0, 5, 1, 8, 1, 0, 0, 0, 0, 0, 0, 0, 0, 14, 36, 0, 1052, 1, 4, 0, 0, 23, 0, 1, 0, 0, 0, 0, 0, 0, 53, 0, 23, 5, 1, 0, 0, 0, 0, 4, 0, 20, 0, 0, 0, 0, 0, 0, 8, 0, 12, 0, 0, 0, 30, 0, 0, 0, 0, 4, 2, 0, 0, 0, 10, 0, 21, 0, 0, 0, 0, 11, 54, 0, 8, 1, 36, 0, 0, 0, 0, 0, 81, 0, 0, 0, 0, 13, 0, 2, 0, 0, 4, 0, 0, 0, 0, 2, 0, 391, 126, 40, 0, 0, 0, 7, 1, 0, 28, 0, 0, 0, 0, 0, 0, 0, 2, 0, 10, 11, 35, 3
Money-and-Power-How-Goldman-Sachs-Came-to-Rule-the-World-by-William-D.-Cohan-_z-lib.org_, 0, 0, 0, 101, 88, 0, 0, 0, 0, 74, 1, 60, 2, 0, 0, 0, 35, 0, 0, 0, 0, 0, 0, 1, 0, 0, 0, 0, 2, 1, 2, 0, 1, 3, 0, 0, 0, 1, 138, 0, 18, 0, 107, 2, 0, 0, 0, 46, 2, 0, 0, 111, 0, 0, 0, 1, 0, 0, 0, 0, 237, 0, 0, 85, 126, 0, 0, 57, 4, 1, 0, 0, 0, 0, 2, 4, 0, 0, 97, 0, 0, 0, 0, 0, 0, 110, 0, 8, 0, 482, 10, 0, 18, 1, 0, 0, 0, 0, 2, 7, 61, 0, 0, 0, 0, 0, 0, 0, 169, 0, 0, 36, 0, 0, 0, 34, 0, 9, 3, 25, 0, 0, 0, 0, 21, 514, 1, 0, 0, 0, 125, 0, 0, 0, 0, 0, 0, 0, 0, 6, 0, 1, 0, 225, 17, 6, 68, 0, 0, 0, 0, 2, 17, 0, 58, 40, 7, 0, 64, 17, 1, 56, 0, 0, 20, 0, 10, 1, 46, 3, 5, 1, 161, 113, 0, 0, 6, 0, 27, 104, 0, 146, 0, 77, 0, 0, 0, 12, 0, 59, 0, 123, 2, 1, 198, 1, 0, 3, 16, 0, 0, 17, 0, 151, 0, 0, 3, 1, 104, 10, 40, 15, 4, 0, 33, 0, 1, 0, 0, 16, 0, 0, 0, 0, 32, 74, 0, 0, 2, 268, 69, 4, 0, 0, 0, 0, 7, 0, 0, 0, 0, 15, 6, 185, 0, 0, 0, 0, 2, 0, 61, 0, 0, 0, 323, 0, 70, 8, 0, 0, 0, 18, 58, 6, 0, 0, 5, 0, 0, 23, 6, 0, 17, 3, 478, 43, 7, 0, 3, 0, 69, 0, 0, 0, 11, 0, 0, 0, 9, 9, 0, 42, 2, 8, 4, 3, 0, 64, 1, 20, 6, 15, 1, 0, 0, 50, 70, 0, 0, 2, 104, 0, 0, 113, 2, 22, 0, 21, 1, 0, 11, 0, 0, 20, 79, 108, 0, 0, 84, 0, 0, 15, 0, 28, 0, 0, 0, 0, 0, 0, 0, 0, 0, 0, 0, 0, 181, 22, 0, 23, 0, 52, 3, 0, 68, 0, 0, 187, 0, 0, 16, 0, 37, 0, 0, 0, 9, 0, 13, 4, 0, 1, 1, 3, 0, 0, 56, 27, 0, 90, 0, 0, 42, 3, 0, 52, 4, 1, 21, 0, 273, 10, 80, 0, 0, 0, 0, 2, 0, 0, 0, 0, 0, 0, 0, 0, 0, 0, 0, 321, 26, 0, 0, 0, 6, 0, 0, 0, 0, 1, 0, 0, 3, 1, 0, 9, 0, 0, 177, 80, 0, 30, 0, 1, 0, 0, 0, 1, 187, 2, 2, 34, 0, 46, 80, 0, 0, 0, 0, 0, 0, 10, 5, 0, 171, 0, 75, 49, 0, 0, 0, 855, 1, 2, 32, 0, 55, 0, 0, 0, 0, 0, 0, 0, 0, 0, 0, 0, 0, 30, 0, 0, 17, 0, 0, 0, 21, 0, 0, 12, 0, 0, 0, 0, 0, 65, 1, 4, 13, 356, 0, 5, 0, 45, 0, 0, 0, 0, 0, 0, 0, 19, 1, 2, 255, 113, 0, 12, 1, 9, 99, 0, 42, 0, 0, 28, 0, 1, 0, 5, 13, 0, 0, 2, 0, 0, 1, 19, 0, 0, 56, 7, 0, 5, 6, 0, 3, 0, 0, 379, 0, 0, 3, 0, 0, 0, 94, 0, 0, 31, 17, 0, 0, 0, 0, 0, 0, 30, 0, 0, 40, 0, 0, 2, 0, 0, 8, 134, 0, 0, 0, 0, 0, 0, 93, 12, 0, 0, 0, 0, 0, 0, 30, 0, 0, 30, 0, 24, 0, 65, 0, 0, 1, 104, 0, 0, 0, 0, 5, 89, 27, 0, 524, 1, 21, 0, 0, 31, 9, 0, 0, 1, 0, 0, 144, 1, 0, 55, 1, 10, 7, 41, 0, 30, 0, 0, 191, 0, 0, 9, 0, 112, 0, 112, 9, 0, 98, 0, 0, 0, 0, 0, 79, 0, 3, 2, 0, 1604, 0, 0, 0, 0, 67, 0, 5, 0, 21, 0, 12, 0, 0, 0, 0, 0, 19, 63, 3479, 13, 0, 0, 269, 221, 0, 0, 108, 4, 13, 106, 24, 5, 0, 25, 0, 0, 2, 3, 0, 0, 0, 1, 56, 133, 0, 0, 0, 0, 108, 43, 0, 0, 0, 153, 0, 0, 73, 2, 74, 15, 0, 0, 0, 3, 0, 2, 0, 99, 0, 0, 0, 10, 0, 0, 24, 8, 0, 1, 0, 0, 1, 0, 0, 0, 6, 0, 0, 25, 1, 0, 0, 41, 0, 5, 244, 18, 0, 0, 11, 34, 0, 0, 62, 0, 0, 0, 0, 0, 0, 0, 374, 0, 1, 0, 0, 87, 1, 0, 142, 0, 0, 22, 7, 26, 0, 8, 6, 65, 19, 2, 66, 87, 0, 1, 0, 123, 47, 0, 50, 11, 0, 0, 0, 0, 0, 0, 0, 0, 0, 32, 0, 0, 0, 2, 0, 6, 0, 0, 0, 0, 41, 0, 0, 0, 18, 0, 7, 0, 0, 14, 25, 0, 210, 0, 24, 33, 2, 142, 62, 3, 0, 0, 0, 0, 0, 0, 4, 0, 2, 14, 89, 39, 28, 0, 5, 9, 0, 0, 47, 0, 0, 0, 0, 100, 0, 0, 0, 0, 3, 0, 7, 0, 0, 8, 19, 2, 0, 0, 6, 7, 1, 8, 245, 53, 17, 0, 0, 0, 5, 0, 3, 481, 57, 0, 11, 17, 90, 53, 0, 52, 4, 0, 4, 20, 18, 0, 4, 2, 0, 0, 0, 0, 0, 0, 0, 125, 0, 0, 0, 0, 63, 0, 0, 0, 57, 1, 2, 88, 0, 2, 0, 30, 0, 0, 8, 0, 53, 0, 0, 1, 24, 0, 0, 3, 21, 0, 99, 0, 1, 0, 0, 0, 5, 0, 0, 0, 14, 0, 0, 180, 1, 0, 18, 2, 0, 4, 0, 21, 0, 1, 0, 0, 0, 7, 0, 397, 26, 0, 0, 0, 245, 0, 0, 0, 67, 0, 1, 3, 114, 0, 0, 67, 0, 0, 1, 292, 0, 13, 8, 0, 0, 0, 1, 0, 1, 0, 0, 0, 0, 33, 82, 14, 0, 0, 0, 6, 3, 5, 0, 3, 24, 6, 6, 1, 1, 94, 0, 0, 0, 1, 0, 190, 20, 0, 0, 4, 8, 0, 0, 0, 4, 0, 86, 7, 0, 0, 0, 0, 0, 0, 0, 0, 1, 0, 87, 0, 0, 69, 0, 0, 0, 503, 0, 4, 0, 0, 4, 177, 3, 1, 1, 0, 0, 0, 88, 4, 0, 0, 127, 66, 17, 0, 0, 0, 3, 3, 0, 0, 0, 39, 88, 0, 0, 0, 0, 6, 297, 0, 8, 0, 1, 21, 557, 22, 0, 0, 103, 111, 0, 0, 0, 10, 0, 36, 32, 216, 0, 0, 0, 188, 106, 0, 0, 0, 0, 0, 3, 629, 153, 0, 1, 28, 0, 4, 44, 3, 19, 13, 180, 3, 0, 0, 0, 2, 0, 87, 285, 18, 2, 0, 0, 0, 0, 0, 40, 112, 9, 0, 1, 0, 77, 6, 0, 5, 0, 139, 0, 0, 0, 0, 0, 0, 0, 0, 13, 28, 0, 235, 72, 0, 0, 0, 4, 219, 0, 1, 0, 0, 0, 0, 0, 0, 0, 4, 0, 11, 0, 0, 40, 3, 1, 0, 22, 1, 0, 46, 0, 9, 3, 489, 1, 0, 0, 0, 0, 0, 0, 2, 0, 0, 0, 0, 1, 99, 112, 0, 139, 17, 110, 1, 85, 0, 0, 2, 3, 42, 0, 21, 1, 0, 0, 0, 11, 2, 0, 0, 16, 1, 0, 0, 16, 22, 0, 0, 20, 0, 19, 0, 0, 0, 2, 17, 1, 77, 73, 0, 0, 0, 0, 0, 1, 0, 84, 0, 0, 0, 24, 6, 0, 0, 0, 3, 0, 0, 0, 0, 0, 0, 16, 0, 0, 0, 1, 2, 0, 0, 62, 2, 0, 0, 611, 16, 0, 83, 39, 0, 0, 0, 1, 4, 2, 65, 0, 0, 280, 44, 0, 466, 1, 0, 0, 0, 1, 0, 62, 0, 49, 0, 431, 0, 1, 32, 0, 0, 193, 0, 0, 0, 81, 5, 18, 234, 86, 0, 0, 0, 4, 0, 0, 0, 0, 1, 1, 0, 0, 0, 0, 0, 2, 0, 0, 0, 0, 19, 0, 0, 1, 191, 43, 182, 0, 0, 21, 43, 0, 0, 97, 39, 1, 0, 0, 2, 0, 0, 0, 0, 0, 4, 0, 47, 0, 18, 17, 0, 0, 66, 0, 0, 0, 10, 2, 34, 0, 79, 0, 34, 0, 5, 0, 16, 194, 0, 2, 0, 0, 0, 0, 0, 0, 18, 369, 0, 0, 11, 0, 0, 28, 26, 30, 132, 0, 0, 22, 165, 0, 221, 0, 5, 0, 1, 0, 7, 0, 25, 1, 0, 0, 0, 30, 4, 0, 0, 57, 36, 22, 0, 0, 38, 0, 72, 0, 0, 0, 1, 3, 0, 0, 0, 0, 3, 2, 0, 6, 0, 0, 0, 10, 32, 0, 57, 0, 2, 3, 20, 6, 0, 0, 5, 0, 0, 2, 211, 45, 2, 9, 0, 0, 0, 2, 0, 738, 14, 19, 0, 0, 0, 0, 56, 197, 0, 0, 0, 3, 9, 10, 2, 0, 0, 66, 0, 0, 0, 2, 0, 46, 0, 2, 0, 44, 0, 0, 0, 0, 1, 3, 1, 0, 75, 3, 0, 0, 4, 0, 0, 0, 0, 0, 0, 195, 0, 0, 12, 12, 19, 0, 0, 0, 3, 0, 1, 8, 0, 25, 0, 0, 0, 0, 20, 0, 0, 0, 0, 0, 3, 1, 3, 13, 36, 27, 0, 0, 100, 0, 0, 1, 782, 32, 63, 0, 550, 1, 1, 0, 0, 4, 0, 0, 249, 4, 0, 0, 0, 0, 0, 0, 0, 77, 0, 3, 0, 0, 0, 37, 0, 8, 0, 1, 0, 18, 0, 0, 22, 14, 77, 352, 0, 0, 70, 87, 0, 0, 708, 0, 0, 0, 53, 18, 3, 0, 0, 0, 10, 0, 15, 3, 0, 342, 52, 0, 0, 0, 22, 0, 0, 93, 0, 60, 0, 0, 0, 0, 0, 1, 137, 1, 410, 82, 0, 0, 0, 0, 5, 7, 0, 70, 0, 0, 2, 1, 0, 0, 237, 1, 46, 0, 0, 0, 38, 0, 0, 0, 0, 4, 33, 0, 0, 47, 0, 0, 27, 0, 0, 1, 0, 21, 138, 0, 9, 1, 4, 5, 0, 15, 2, 0, 7, 0, 0, 1, 8, 40, 0, 10, 0, 0, 14, 6, 0, 0, 0, 32, 679, 0, 2, 71, 0, 0, 0, 11, 108, 0, 67, 0, 0, 0, 0, 0, 0, 0, 31, 0, 63, 191, 64, 1
Mærsk-Mc-Kinney-Møller-The-Danish-Shipping-Magnate-by-Larsen_-ThomasMortensen_-Finn-_z-lib.org_, 1067, 0, 0, 9, 60, 41, 0, 0, 0, 64, 0, 7, 0, 0, 0, 0, 0, 0, 0, 0, 0, 0, 0, 10, 0, 0, 0, 0, 0, 0, 0, 0, 0, 0, 1, 0, 0, 4, 21, 0, 22, 0, 60, 0, 0, 0, 0, 6, 0, 0, 0, 31, 0, 0, 0, 0, 0, 0, 0, 0, 23, 0, 2, 0, 1, 0, 0, 2, 0, 1, 0, 0, 0, 0, 0, 0, 0, 0, 12, 0, 0, 0, 0, 0, 0, 11, 0, 4, 0, 15, 0, 0, 4, 0, 0, 0, 1, 0, 3, 3, 0, 0, 0, 0, 0, 0, 0, 0, 12, 0, 0, 10, 0, 0, 0, 6, 0, 1, 1, 0, 0, 0, 0, 0, 11, 82, 0, 0, 0, 0, 0, 0, 0, 0, 0, 0, 0, 0, 0, 16, 0, 14, 0, 0, 0, 4, 24, 0, 0, 0, 0, 0, 0, 0, 11, 6, 7, 0, 23, 1, 0, 13, 0, 0, 2, 53, 3, 0, 5, 64, 0, 0, 0, 26, 0, 0, 0, 0, 18, 76, 0, 33, 0, 10, 0, 0, 0, 23, 0, 1, 0, 0, 1, 0, 2, 0, 0, 12, 7, 0, 0, 0, 64, 49, 0, 0, 3, 0, 3, 0, 5, 6, 0, 6, 21, 0, 0, 0, 0, 2, 0, 0, 0, 0, 0, 0, 0, 0, 0, 0, 0, 1, 0, 2, 0, 0, 4, 0, 0, 0, 0, 20, 7, 0, 0, 0, 80, 2, 1, 0, 46, 0, 0, 0, 17, 0, 19, 0, 0, 0, 0, 4, 4, 0, 0, 0, 0, 0, 0, 7, 7, 0, 21, 0, 6, 12, 0, 1, 2, 0, 10, 0, 0, 0, 3, 0, 0, 0, 0, 9, 0, 8, 0, 4, 0, 1, 139, 20, 1, 5, 0, 7, 0, 0, 0, 57, 37, 0, 0, 0, 37, 0, 0, 0, 0, 3, 0, 1, 0, 0, 8, 0, 0, 3, 0, 0, 0, 0, 35, 0, 0, 11, 0, 2, 5, 0, 0, 0, 0, 0, 1, 0, 0, 0, 0, 0, 111, 0, 0, 31, 0, 4, 0, 0, 37, 1, 0, 173, 39, 0, 6, 0, 0, 0, 0, 0, 9, 0, 7, 0, 0, 0, 0, 0, 0, 0, 21, 0, 11, 8, 0, 0, 12, 0, 0, 36, 0, 0, 3, 0, 0, 15, 0, 0, 0, 0, 0, 0, 0, 0, 0, 0, 0, 0, 20, 0, 0, 0, 58, 33, 2, 4, 0, 0, 1, 0, 0, 0, 0, 1, 0, 0, 2, 0, 0, 4, 0, 0, 28, 0, 0, 0, 0, 0, 3, 0, 0, 0, 44, 2, 0, 13, 0, 0, 77, 0, 0, 0, 0, 0, 0, 2, 2, 0, 2, 0, 62, 13, 0, 2, 0, 231, 0, 1, 0, 0, 8, 0, 0, 1, 0, 0, 0, 0, 0, 0, 0, 0, 0, 16, 0, 0, 2, 0, 0, 0, 12, 0, 0, 0, 0, 0, 0, 1, 0, 0, 5, 0, 24, 4, 0, 1, 0, 35, 0, 0, 0, 0, 0, 0, 0, 0, 0, 0, 59, 70, 0, 1, 0, 0, 0, 0, 34, 0, 0, 33, 0, 0, 0, 0, 3, 0, 0, 0, 0, 2, 0, 9, 0, 0, 11, 13, 7, 3, 0, 0, 0, 0, 0, 0, 0, 0, 5, 0, 0, 0, 8, 0, 0, 11, 0, 0, 0, 0, 0, 0, 0, 3, 0, 0, 21, 0, 0, 3, 0, 0, 0, 25, 0, 0, 2, 0, 0, 0, 0, 4, 0, 54, 0, 0, 0, 0, 2, 0, 0, 9, 4, 4, 0, 74, 0, 111, 0, 51, 0, 0, 0, 0, 5, 4, 25, 0, 5, 0, 18, 0, 0, 6, 5, 0, 0, 4, 0, 0, 8, 0, 0, 40, 0, 1, 0, 22, 0, 11, 0, 0, 10, 0, 0, 0, 0, 19, 0, 0, 6, 0, 16, 0, 0, 0, 0, 0, 4, 0, 0, 0, 0, 9, 0, 0, 0, 0, 38, 0, 0, 0, 2, 0, 0, 0, 0, 0, 0, 85, 2, 21, 0, 0, 0, 0, 0, 50, 0, 0, 2, 10, 0, 0, 0, 2, 0, 5, 0, 0, 4, 10, 0, 0, 0, 0, 27, 1, 0, 0, 0, 0, 29, 5, 0, 4, 0, 21, 0, 0, 10, 0, 4, 0, 0, 0, 0, 0, 0, 4, 0, 7, 0, 22, 2, 2, 0, 0, 30, 4, 0, 0, 0, 0, 20, 0, 0, 0, 0, 0, 0, 8, 3, 0, 0, 25, 0, 2, 11, 0, 0, 0, 0, 0, 0, 0, 5, 0, 0, 0, 0, 0, 10, 0, 25, 0, 118, 0, 0, 7, 0, 0, 6, 0, 0, 42, 0, 2, 0, 10, 0, 35, 95, 0, 13, 5, 0, 0, 0, 0, 0, 0, 15, 0, 0, 0, 0, 0, 0, 0, 0, 0, 0, 29, 0, 0, 0, 3, 0, 0, 0, 0, 0, 0, 3, 0, 0, 0, 10, 0, 0, 0, 0, 8, 7, 0, 8, 0, 5, 1, 0, 0, 0, 0, 0, 0, 0, 0, 0, 0, 1, 0, 0, 35, 31, 11, 10, 0, 4, 0, 0, 0, 12, 0, 0, 0, 0, 2, 0, 0, 0, 0, 4, 0, 0, 0, 0, 0, 6, 0, 0, 1, 20, 0, 8, 4, 1, 6, 8, 0, 0, 0, 1, 0, 0, 116, 22, 0, 39, 0, 0, 47, 0, 6, 0, 0, 0, 1, 9, 0, 0, 5, 0, 0, 0, 0, 0, 0, 0, 42, 0, 0, 7, 0, 15, 0, 0, 0, 0, 0, 0, 11, 0, 0, 0, 0, 0, 0, 15, 0, 12, 0, 0, 1, 4, 0, 0, 0, 9, 0, 0, 2, 0, 0, 0, 0, 1, 0, 0, 0, 2, 0, 0, 4, 61, 0, 2, 1, 0, 3, 0, 3, 0, 0, 0, 0, 0, 3, 0, 0, 44, 0, 0, 0, 12, 0, 0, 0, 17, 0, 0, 0, 50, 0, 0, 43, 0, 0, 1, 25, 0, 53, 1, 0, 0, 0, 0, 0, 0, 0, 0, 0, 1, 14, 27, 10, 0, 0, 0, 18, 0, 1, 0, 0, 6, 30, 2, 2, 0, 104, 0, 0, 0, 0, 0, 13, 5, 0, 0, 0, 0, 5, 0, 0, 1, 0, 12, 0, 0, 0, 0, 0, 0, 0, 0, 0, 0, 0, 16, 0, 0, 8, 0, 0, 62, 1, 0, 3, 0, 1, 1, 6, 1, 0, 2, 0, 60, 0, 11, 4, 0, 0, 14, 0, 13, 0, 0, 0, 3, 0, 0, 0, 0, 0, 16, 0, 0, 0, 0, 0, 11, 0, 8, 0, 2, 6, 19, 0, 0, 0, 17, 52, 8, 0, 0, 1, 0, 58, 0, 87, 0, 0, 0, 31, 12, 0, 62, 0, 0, 0, 0, 0, 33, 0, 1, 1, 413, 4, 8, 1, 4, 0, 40, 1, 0, 0, 0, 2, 0, 57, 0, 3, 0, 0, 0, 0, 0, 0, 1, 17, 0, 0, 2, 0, 11, 0, 0, 0, 0, 0, 0, 0, 0, 0, 0, 0, 0, 0, 2, 31, 0, 0, 0, 46, 0, 0, 2, 65, 0, 0, 0, 0, 0, 0, 0, 0, 0, 1, 1, 20, 22, 0, 11, 3, 0, 76, 0, 0, 0, 12, 0, 3, 0, 19, 0, 0, 0, 0, 0, 0, 0, 0, 1, 0, 0, 0, 0, 26, 9, 0, 29, 1, 4, 0, 0, 0, 0, 0, 0, 1, 0, 23, 1, 0, 0, 0, 8, 3, 0, 0, 17, 8, 0, 0, 9, 2, 0, 0, 0, 0, 1, 0, 0, 0, 2, 5, 0, 0, 1, 0, 0, 0, 0, 0, 1, 0, 20, 0, 0, 0, 2, 5, 0, 0, 0, 0, 0, 0, 0, 0, 0, 0, 54, 0, 0, 0, 0, 0, 0, 0, 5, 0, 0, 0, 518, 0, 0, 0, 6, 0, 0, 0, 4, 6, 0, 0, 0, 0, 12, 0, 0, 41, 2, 0, 1, 0, 2, 0, 0, 0, 20, 0, 0, 1, 0, 0, 0, 0, 5, 0, 0, 0, 22, 0, 13, 41, 11, 2, 0, 0, 0, 0, 0, 0, 0, 1, 0, 0, 0, 0, 0, 0, 0, 0, 0, 0, 0, 8, 0, 0, 0, 90, 13, 19, 0, 0, 7, 2, 0, 0, 36, 14, 0, 0, 0, 1, 0, 0, 0, 0, 0, 4, 0, 22, 0, 9, 12, 0, 0, 25, 0, 0, 0, 2, 0, 27, 0, 239, 0, 59, 0, 10, 0, 5, 30, 0, 0, 0, 0, 0, 0, 0, 0, 48, 34, 0, 0, 1, 0, 0, 16, 20, 3, 12, 0, 0, 0, 8, 0, 19, 0, 2, 0, 3, 0, 0, 0, 10, 11, 0, 0, 0, 8, 0, 0, 0, 5, 3, 0, 121, 0, 6, 0, 35, 0, 0, 0, 0, 0, 0, 0, 0, 0, 3, 0, 1, 0, 0, 0, 0, 0, 36, 0, 1, 0, 0, 1, 19, 4, 0, 0, 0, 0, 0, 0, 0, 24, 2, 151, 10, 113, 0, 4, 0, 215, 0, 13, 0, 0, 0, 0, 0, 0, 0, 0, 0, 3, 0, 2, 0, 1, 0, 10, 0, 0, 0, 0, 0, 10, 0, 0, 0, 5, 0, 0, 0, 2, 0, 0, 0, 0, 32, 0, 0, 0, 0, 0, 0, 0, 0, 0, 0, 6, 0, 0, 0, 0, 0, 0, 3, 0, 0, 0, 0, 0, 0, 0, 0, 0, 0, 0, 7, 0, 0, 0, 0, 0, 4, 4, 6, 0, 22, 4, 0, 0, 39, 0, 0, 0, 12, 0, 30, 0, 0, 6, 10, 0, 0, 0, 0, 49, 6, 0, 0, 0, 0, 0, 0, 0, 0, 1, 0, 0, 0, 0, 0, 3, 0, 0, 0, 1, 0, 1, 0, 0, 0, 1, 3, 16, 0, 0, 15, 26, 0, 0, 0, 0, 0, 0, 0, 16, 0, 0, 0, 0, 0, 0, 0, 0, 0, 25, 20, 0, 0, 0, 26, 0, 0, 24, 1, 10, 0, 0, 0, 0, 0, 0, 23, 0, 21, 13, 0, 0, 20, 0, 1, 27, 0, 0, 0, 0, 0, 0, 0, 0, 6, 0, 13, 0, 0, 0, 1, 0, 0, 0, 0, 0, 29, 0, 0, 8, 2, 0, 15, 0, 0, 2, 0, 17, 106, 0, 4, 11, 2, 0, 0, 5, 2, 0, 2, 0, 38, 4, 0, 23, 0, 21, 0, 0, 12, 0, 0, 0, 0, 4, 0, 0, 0, 77, 0, 0, 0, 0, 68, 0, 29, 0, 2, 0, 0, 0, 0, 0, 0, 6, 1, 66, 7, 0
Of-Permanent-Value_-The-Story-of-Warren-Bu-Andrew-Kilpatrick, 0, 0, 0, 237, 273, 0, 0, 0, 0, 202, 29, 288, 47, 0, 0, 0, 16, 0, 0, 0, 0, 1, 0, 52, 0, 0, 0, 16, 73, 6, 1, 0, 2, 1, 1, 0, 2, 12, 273, 0, 212, 1, 95, 0, 5, 0, 1, 211, 22, 0, 0, 197, 0, 0, 4, 9, 0, 0, 0, 0, 216, 6, 11, 7, 160, 0, 0, 123, 0, 15, 1, 0, 7, 0, 51, 2, 0, 0, 154, 0, 0, 0, 0, 0, 0, 152, 0, 10, 0, 1047, 19, 0, 68, 2, 0, 0, 6, 0, 15, 65, 82, 3, 1, 0, 1, 0, 58, 0, 529, 6, 0, 71, 34, 0, 0, 42, 4, 46, 48, 0, 1, 2, 1, 0, 58, 894, 4, 0, 0, 1, 148, 1, 1, 8, 0, 0, 0, 0, 0, 19, 0, 0, 0, 3, 0, 60, 394, 0, 4, 0, 0, 4, 21, 0, 82, 45, 22, 1, 265, 154, 4, 186, 0, 0, 15, 0, 57, 19, 515, 16, 0, 9, 68, 124, 4, 0, 24, 1, 86, 411, 0, 80, 0, 143, 0, 0, 3, 137, 0, 273, 0, 0, 21, 20, 204, 3, 0, 125, 47, 0, 0, 18, 0, 203, 127, 0, 37, 1, 59, 72, 61, 161, 74, 0, 49, 0, 1118, 1, 0, 127, 0, 0, 0, 0, 14, 0, 0, 1, 45, 1, 8, 15, 0, 0, 0, 0, 93, 2, 4, 0, 0, 105, 43, 15, 13, 0, 0, 4, 4, 28, 167, 0, 0, 3, 1986, 1, 98, 3, 0, 0, 0, 79, 60, 80, 1, 0, 23, 0, 0, 103, 10, 0, 120, 34, 336, 99, 62, 3, 3, 0, 151, 0, 0, 0, 18, 0, 1, 0, 3, 15, 0, 72, 48, 21, 105, 82, 0, 146, 4, 43, 30, 108, 2, 0, 0, 292, 95, 1, 0, 11, 106, 0, 0, 1, 6, 156, 4, 27, 0, 5, 45, 0, 0, 112, 1, 0, 0, 0, 954, 0, 0, 214, 0, 157, 10, 0, 0, 0, 0, 0, 10, 0, 0, 0, 0, 0, 161, 76, 0, 42, 0, 70, 12, 2, 266, 1, 4, 459, 0, 0, 57, 0, 116, 50, 0, 0, 41, 0, 63, 17, 0, 1, 12, 123, 0, 0, 120, 92, 3, 511, 344, 0, 108, 2, 0, 38, 9, 6, 111, 0, 81, 19, 0, 0, 0, 0, 0, 3, 3, 0, 0, 0, 32, 0, 1, 0, 0, 4, 1, 481, 10, 0, 0, 19, 91, 2, 0, 0, 0, 2, 2, 0, 11, 3, 0, 89, 8, 0, 257, 0, 1, 34, 0, 2, 10, 1, 8, 2, 480, 14, 1, 68, 0, 13, 494, 6, 8, 0, 0, 0, 0, 21, 19, 0, 147, 3, 337, 44, 2, 0, 0, 1684, 10, 16, 12, 0, 88, 0, 0, 0, 1, 0, 0, 0, 0, 0, 0, 0, 1, 195, 0, 0, 93, 0, 1, 0, 47, 0, 22, 0, 0, 0, 9, 1, 0, 0, 1293, 25, 96, 71, 0, 5, 0, 101, 0, 0, 0, 2, 0, 0, 0, 23, 27, 3, 224, 513, 0, 79, 8, 1, 10, 0, 476, 0, 2, 267, 1, 3, 0, 52, 49, 1, 0, 0, 0, 11, 3, 56, 0, 0, 87, 43, 0, 19, 25, 0, 18, 9, 0, 1, 0, 1, 131, 2, 1, 0, 160, 0, 0, 99, 107, 2, 0, 1, 0, 0, 0, 111, 0, 0, 137, 3, 0, 56, 0, 0, 38, 392, 47, 357, 24, 17, 0, 1, 102, 11, 0, 0, 8, 0, 0, 0, 52, 0, 0, 36, 0, 84, 0, 230, 0, 0, 2, 145, 163, 0, 0, 0, 18, 77, 243, 342, 427, 0, 99, 0, 0, 59, 38, 0, 1, 4, 1, 0, 242, 4, 0, 74, 14, 98, 6, 177, 12, 79, 0, 0, 854, 0, 0, 25, 0, 150, 2, 2, 81, 0, 200, 19, 0, 0, 10, 0, 81, 0, 40, 7, 1, 364, 0, 0, 1, 9, 79, 0, 1, 0, 70, 0, 655, 0, 5, 0, 7, 0, 36, 89, 103, 4, 0, 16, 25, 218, 0, 0, 53, 5, 14, 35, 96, 5, 2, 52, 0, 0, 39, 19, 1, 0, 0, 35, 237, 162, 0, 0, 0, 8, 149, 121, 0, 0, 0, 337, 0, 2, 185, 7, 294, 0, 0, 2, 0, 47, 2, 0, 0, 152, 0, 21, 1, 190, 0, 1, 23, 153, 0, 4, 1, 0, 1, 0, 0, 0, 1, 0, 0, 23, 96, 222, 14, 130, 0, 11, 201, 2, 0, 0, 9, 8629, 0, 0, 176, 0, 0, 0, 3, 0, 0, 0, 152, 0, 1, 0, 0, 322, 10, 4, 90, 0, 0, 319, 26, 46, 0, 45, 28, 158, 130, 0, 99, 19, 0, 1, 2, 104, 0, 0, 356, 0, 3, 0, 0, 0, 0, 0, 0, 0, 0, 88, 0, 2, 0, 38, 0, 12, 11, 0, 0, 0, 99, 0, 0, 0, 90, 0, 35, 0, 0, 28, 47, 16, 256, 11, 40, 380, 1, 14, 13, 23, 1, 4, 0, 0, 19, 0, 12, 4, 12, 22, 112, 106, 116, 14, 3, 1, 0, 0, 354, 2, 1, 0, 14, 295, 0, 0, 0, 1, 9, 0, 72, 0, 0, 43, 22, 484, 0, 2, 84, 30, 2, 34, 32, 48, 85, 0, 0, 1, 478, 0, 63, 778, 69, 0, 28, 3, 0, 175, 0, 92, 0, 1, 10, 143, 55, 1, 395, 16, 0, 3, 1, 0, 0, 4, 0, 165, 0, 0, 0, 0, 55, 0, 0, 0, 0, 1, 1, 94, 9, 1, 0, 1, 0, 0, 24, 5, 262, 0, 3, 21, 46, 71, 0, 5, 160, 0, 0, 2, 19, 0, 0, 0, 37, 0, 0, 0, 21, 0, 0, 306, 8, 0, 80, 5, 0, 39, 0, 367, 0, 27, 0, 0, 165, 14, 0, 3, 91, 25, 0, 0, 439, 0, 0, 0, 109, 1, 21, 2, 176, 0, 0, 224, 3, 0, 5, 1499, 0, 56, 22, 0, 0, 0, 6, 1, 20, 0, 7, 1, 23, 51, 52, 7, 0, 0, 0, 16, 14, 6, 0, 68, 31, 26, 17, 11, 0, 393, 0, 7, 0, 2, 6, 145, 32, 0, 0, 8, 23, 0, 0, 0, 3, 0, 230, 0, 0, 0, 11, 0, 0, 1, 0, 0, 8, 0, 295, 0, 0, 187, 0, 2, 12, 215, 0, 32, 0, 9, 3, 107, 10, 19, 1, 0, 0, 0, 280, 8, 0, 0, 195, 0, 225, 0, 0, 0, 25, 6, 0, 0, 0, 17, 116, 0, 0, 0, 0, 16, 497, 0, 22, 0, 3, 46, 862, 45, 0, 5, 97, 57, 2, 0, 0, 31, 0, 100, 0, 338, 4, 0, 4, 50, 158, 0, 0, 0, 0, 0, 50, 64, 297, 0, 4, 10, 0, 40, 88, 14, 126, 0, 180, 12, 0, 0, 0, 44, 0, 142, 561, 110, 2, 0, 0, 0, 0, 0, 13, 276, 22, 7, 20, 0, 283, 0, 0, 2, 0, 24, 0, 1, 0, 0, 0, 6, 0, 2, 22, 50, 1, 0, 25, 0, 0, 0, 12, 332, 0, 28, 5, 0, 0, 0, 0, 0, 0, 8, 1, 51, 0, 0, 97, 32, 0, 0, 47, 8, 0, 110, 22, 22, 175, 417, 14, 0, 0, 0, 0, 0, 0, 4, 2, 0, 0, 0, 1, 247, 140, 0, 292, 10, 192, 43, 69, 0, 0, 0, 25, 135, 0, 68, 98, 0, 0, 0, 64, 19, 0, 0, 76, 12, 0, 0, 15, 45, 0, 2, 0, 0, 58, 0, 0, 0, 1, 42, 7, 96, 356, 0, 0, 0, 0, 0, 3, 0, 1078, 0, 1, 0, 104, 42, 9, 869, 3, 155, 4, 0, 0, 11, 0, 0, 109, 2, 0, 0, 18, 4, 0, 0, 21, 5, 0, 0, 2325, 30, 0, 0, 1583, 0, 0, 2, 15, 25, 1, 80, 0, 0, 371, 18, 0, 575, 20, 0, 4, 2, 37, 0, 77, 0, 288, 3, 8, 0, 0, 72, 0, 1, 1108, 8, 0, 0, 128, 50, 161, 372, 10, 1, 0, 0, 0, 3, 0, 16, 0, 53, 20, 10, 0, 8, 0, 2, 30, 0, 1, 0, 0, 77, 0, 1, 11, 1186, 147, 337, 22, 0, 55, 37, 0, 0, 82, 43, 0, 0, 0, 28, 0, 0, 4, 4, 0, 31, 1, 193, 11, 35, 23, 0, 0, 784, 0, 0, 0, 117, 0, 75, 0, 274, 0, 165, 0, 32, 0, 17, 543, 10, 0, 0, 0, 0, 0, 1, 0, 19, 1162, 0, 0, 74, 0, 1, 57, 60, 70, 796, 0, 0, 47, 108, 5, 189, 0, 85, 0, 1, 9, 72, 0, 29, 8, 0, 0, 0, 80, 24, 0, 0, 61, 64, 79, 0, 0, 59, 0, 172, 2, 0, 1, 14, 23, 0, 0, 0, 2, 13, 5, 1, 52, 0, 2, 2, 1, 88, 5, 90, 1, 6, 13, 25, 59, 0, 0, 22, 72, 202, 6, 1, 192, 57, 39, 1, 0, 0, 0, 0, 2239, 76, 27, 0, 0, 0, 0, 309, 66, 0, 0, 1, 1, 9, 41, 4, 30, 0, 55, 0, 0, 39, 0, 0, 82, 4, 8, 0, 61, 0, 0, 0, 3, 0, 0, 5, 0, 158, 19, 1, 0, 6, 0, 1, 2, 12, 1, 0, 40, 0, 0, 16, 85, 24, 0, 3, 0, 5, 2, 1, 32, 0, 108, 0, 0, 0, 6, 76, 3, 0, 0, 14, 1, 44, 1, 16, 62, 41, 111, 38, 0, 362, 2, 0, 1, 286, 34, 188, 0, 8, 5, 10, 0, 1, 5, 0, 0, 391, 21, 0, 0, 0, 0, 0, 0, 0, 375, 0, 26, 0, 0, 0, 101, 2, 26, 0, 6, 0, 71, 0, 0, 37, 54, 716, 893, 0, 0, 410, 338, 0, 0, 51, 0, 0, 1, 17, 34, 47, 0, 0, 3, 36, 0, 13, 2, 9, 210, 168, 130, 0, 3, 103, 0, 0, 205, 7, 125, 0, 0, 0, 0, 0, 1, 342, 5, 374, 219, 3, 0, 0, 37, 3, 10, 0, 128, 337, 0, 0, 8, 0, 0, 121, 18, 123, 0, 0, 1, 43, 0, 0, 0, 1, 22, 251, 4, 83, 114, 0, 0, 85, 1, 6, 3, 0, 123, 300, 0, 13, 6, 16, 123, 0, 12, 38, 0, 30, 0, 0, 21, 5, 125, 2, 66, 0, 0, 5, 4946, 0, 1, 0, 45, 14, 0, 5, 384, 0, 0, 0, 34, 252, 0, 133, 0, 2, 0, 0, 1, 0, 0, 13, 9, 84, 257, 71, 49
Philip-Augar-The-Bank-That-Lived-a-Little_-Barclays-in-the-Age-of-the-Very-Free-Market-_2018_-libgen, 0, 0, 0, 33, 28, 0, 0, 0, 0, 35, 0, 20, 595, 0, 0, 0, 16, 0, 0, 0, 0, 0, 0, 4, 0, 0, 0, 0, 24, 0, 50, 0, 0, 1, 12, 0, 0, 0, 99, 0, 9, 0, 9, 1, 0, 0, 0, 47, 0, 0, 0, 105, 0, 0, 9, 28, 2, 0, 75, 0, 96, 0, 0, 8, 49, 0, 0, 2, 2, 3, 0, 0, 0, 0, 0, 3, 0, 0, 39, 0, 0, 293, 0, 0, 0, 3, 61, 0, 0, 126, 1, 0, 8, 0, 0, 0, 1, 0, 1, 22, 86, 0, 0, 0, 0, 0, 0, 0, 45, 0, 0, 26, 0, 0, 0, 18, 0, 4, 0, 0, 0, 0, 0, 0, 0, 261, 0, 0, 0, 0, 3, 0, 0, 0, 0, 0, 0, 1, 0, 4, 0, 6, 0, 1, 0, 4, 131, 0, 1, 0, 0, 0, 0, 0, 38, 11, 0, 0, 57, 4, 0, 41, 0, 0, 0, 0, 7, 1, 39, 65, 0, 1, 4, 46, 0, 0, 0, 1, 56, 221, 37, 28, 0, 50, 0, 0, 0, 6, 0, 2, 0, 0, 5, 0, 85, 1, 0, 2, 3, 0, 0, 12, 0, 115, 1, 0, 1, 0, 12, 1, 15, 8, 0, 0, 9, 0, 1, 0, 0, 27, 0, 0, 0, 0, 2, 0, 0, 0, 2, 0, 8, 1, 0, 0, 0, 0, 1, 0, 0, 0, 0, 14, 3, 0, 0, 0, 0, 2, 0, 0, 28, 0, 0, 0, 77, 0, 24, 0, 0, 0, 0, 2, 10, 0, 0, 0, 0, 0, 0, 15, 5, 0, 17, 0, 47, 39, 0, 1, 217, 0, 18, 0, 0, 0, 15, 0, 0, 0, 3, 8, 0, 29, 1, 1, 4, 3, 0, 18, 2, 14, 0, 28, 0, 0, 0, 52, 54, 0, 0, 1, 32, 0, 0, 0, 0, 15, 0, 23, 0, 0, 2, 0, 0, 4, 1, 0, 0, 0, 51, 0, 0, 10, 0, 13, 5, 0, 0, 0, 0, 0, 2, 0, 0, 0, 0, 0, 45, 58, 0, 131, 0, 23, 2, 0, 103, 0, 0, 441, 0, 0, 10, 0, 0, 1, 0, 0, 1, 0, 5, 5, 0, 4, 0, 6, 0, 0, 29, 0, 0, 63, 0, 0, 20, 0, 0, 22, 14, 0, 2, 0, 178, 12, 0, 0, 0, 0, 0, 0, 0, 0, 0, 0, 0, 0, 0, 0, 0, 2, 0, 89, 4, 0, 0, 0, 0, 0, 1, 0, 0, 0, 0, 0, 0, 0, 0, 11, 0, 0, 65, 0, 0, 2, 0, 0, 0, 3, 0, 0, 34, 0, 0, 18, 0, 55, 40, 0, 0, 0, 0, 0, 0, 2, 0, 0, 10, 0, 120, 39, 0, 0, 0, 371, 0, 0, 0, 0, 294, 0, 0, 0, 0, 0, 0, 0, 0, 0, 0, 0, 0, 9, 0, 1, 11, 0, 1, 0, 29, 0, 1, 0, 0, 0, 0, 0, 0, 0, 3, 1, 13, 65, 0, 0, 0, 8, 0, 0, 0, 0, 0, 0, 0, 5, 4, 0, 77, 64, 0, 30, 1328, 0, 0, 0, 15, 0, 0, 25, 0, 0, 0, 0, 12, 1, 0, 0, 0, 0, 3, 9, 0, 1, 61, 6, 1, 2, 3, 0, 0, 7, 0, 1, 0, 0, 3, 0, 0, 0, 123, 0, 0, 21, 8, 0, 0, 0, 0, 0, 0, 7, 0, 0, 22, 0, 0, 4, 0, 0, 5, 61, 0, 0, 23, 0, 0, 3, 44, 11, 0, 0, 4, 0, 0, 0, 8, 0, 0, 15, 0, 1, 0, 16, 0, 0, 1, 47, 0, 69, 0, 0, 2, 173, 31, 0, 154, 0, 4, 0, 0, 25, 97, 0, 0, 0, 0, 0, 94, 2, 0, 32, 2, 7, 8, 18, 0, 36, 0, 0, 149, 0, 0, 8, 0, 61, 0, 1, 6, 0, 26, 0, 0, 0, 0, 0, 20, 0, 1, 1, 0, 122, 0, 0, 0, 0, 28, 0, 0, 0, 26, 0, 16, 0, 2, 0, 0, 0, 40, 44, 40, 0, 0, 0, 0, 89, 0, 0, 32, 1, 2, 0, 10, 6, 0, 8, 0, 0, 2, 15, 0, 0, 0, 1, 61, 100, 0, 0, 0, 0, 92, 22, 0, 1, 0, 20, 0, 0, 16, 2, 110, 0, 0, 0, 0, 1, 0, 12, 0, 22, 0, 1, 15, 8, 0, 0, 72, 2, 0, 98, 0, 0, 16, 0, 0, 0, 0, 0, 0, 13, 0, 0, 0, 2, 0, 4, 36, 0, 0, 0, 0, 5, 0, 0, 18, 0, 0, 0, 0, 0, 0, 0, 135, 0, 0, 0, 0, 69, 1, 1, 9, 0, 0, 3, 1, 4, 0, 8, 0, 14, 3, 1, 46, 2, 0, 0, 0, 2, 0, 0, 79, 1, 0, 0, 0, 0, 0, 0, 0, 0, 0, 25, 0, 0, 0, 9, 0, 3, 0, 0, 0, 0, 25, 0, 0, 8, 21, 0, 1, 0, 0, 4, 10, 0, 129, 0, 74, 9, 0, 0, 0, 10, 2, 2, 0, 0, 0, 0, 18, 0, 5, 25, 20, 20, 7, 0, 1, 0, 0, 0, 15, 0, 2, 1, 0, 88, 0, 0, 0, 0, 6, 0, 1, 0, 0, 38, 25, 0, 0, 0, 0, 16, 0, 5, 56, 17, 15, 0, 0, 0, 0, 0, 0, 173, 16, 0, 3, 0, 0, 24, 0, 13, 0, 0, 1, 11, 10, 0, 0, 4, 0, 0, 0, 0, 0, 0, 0, 156, 0, 0, 1, 0, 0, 0, 0, 0, 0, 0, 1, 67, 0, 0, 0, 0, 0, 0, 13, 0, 18, 0, 0, 0, 11, 3, 0, 2, 32, 0, 0, 1, 10, 0, 0, 43, 0, 0, 0, 0, 6, 0, 0, 13, 7, 0, 13, 0, 0, 5, 0, 2, 0, 2, 0, 0, 0, 0, 0, 0, 14, 0, 0, 0, 367, 0, 0, 0, 30, 0, 0, 0, 28, 0, 0, 62, 0, 0, 0, 188, 0, 17, 0, 0, 0, 0, 1, 0, 5, 0, 0, 0, 0, 13, 33, 5, 1, 0, 2, 3, 2, 3, 0, 2, 12, 0, 1, 1, 0, 65, 0, 0, 0, 0, 0, 121, 9, 0, 0, 9, 14, 0, 0, 0, 4, 0, 40, 0, 0, 0, 1, 0, 0, 0, 0, 0, 2, 0, 79, 0, 0, 60, 0, 7, 0, 118, 0, 2, 0, 0, 3, 25, 4, 0, 0, 0, 0, 0, 38, 1, 0, 0, 61, 0, 18, 0, 0, 0, 44, 0, 0, 0, 0, 0, 63, 0, 0, 0, 0, 1, 200, 0, 1, 68, 0, 11, 306, 2, 0, 0, 53, 49, 0, 0, 0, 0, 0, 55, 0, 138, 0, 1, 0, 128, 12, 0, 0, 0, 0, 0, 6, 77, 82, 0, 0, 0, 0, 7, 57, 1, 13, 5, 437, 2, 0, 0, 0, 2, 0, 30, 133, 12, 0, 0, 0, 0, 0, 0, 22, 39, 40, 0, 10, 0, 38, 2, 0, 3, 0, 1, 0, 0, 0, 0, 0, 0, 34, 20, 3, 12, 0, 0, 111, 0, 0, 0, 1, 149, 0, 0, 0, 0, 0, 0, 3, 0, 0, 0, 1, 12, 1, 0, 19, 0, 1, 0, 5, 0, 0, 43, 0, 2, 11, 137, 0, 0, 0, 0, 0, 0, 0, 1, 0, 0, 0, 0, 0, 84, 27, 0, 95, 9, 44, 13, 2, 0, 0, 0, 3, 24, 0, 31, 3, 0, 128, 0, 7, 1, 0, 0, 24, 1, 0, 0, 0, 12, 0, 0, 41, 0, 7, 0, 0, 0, 1, 53, 1, 11, 33, 0, 0, 0, 0, 0, 0, 0, 27, 0, 0, 0, 8, 3, 0, 0, 0, 0, 1, 0, 0, 0, 0, 0, 8, 0, 0, 0, 0, 0, 0, 0, 1, 1, 0, 0, 95, 11, 0, 0, 46, 0, 0, 0, 0, 3, 1, 132, 0, 0, 1081, 12, 0, 163, 1, 0, 1, 0, 0, 0, 2, 0, 106, 0, 0, 0, 0, 0, 0, 0, 93, 1, 0, 0, 4, 0, 16, 72, 33, 0, 0, 0, 0, 0, 1, 0, 0, 4, 0, 4, 0, 1, 0, 0, 0, 0, 0, 0, 32, 58, 0, 0, 0, 241, 19, 46, 0, 0, 13, 8, 0, 0, 31, 8, 0, 0, 0, 2, 0, 0, 0, 1, 0, 2, 0, 29, 0, 25, 2, 0, 0, 186, 0, 0, 0, 9, 0, 16, 0, 14, 0, 39, 0, 12, 0, 17, 100, 0, 0, 0, 0, 0, 0, 2, 0, 8, 395, 0, 0, 3, 0, 0, 21, 25, 0, 37, 0, 0, 2, 18, 0, 77, 0, 1, 0, 0, 0, 6, 0, 35, 0, 0, 0, 0, 22, 0, 0, 0, 62, 4, 2, 0, 0, 13, 0, 32, 2, 0, 0, 0, 2, 0, 0, 0, 0, 0, 1, 33, 0, 0, 0, 0, 0, 99, 0, 6, 0, 0, 0, 27, 86, 0, 0, 1, 0, 0, 0, 0, 16, 1, 1, 0, 0, 0, 2, 0, 444, 32, 10, 0, 0, 0, 0, 3, 326, 0, 0, 2, 3, 0, 3, 0, 1, 0, 29, 0, 0, 0, 0, 0, 71, 0, 1, 0, 5, 0, 0, 0, 2, 0, 0, 0, 0, 31, 0, 0, 0, 2, 0, 0, 0, 0, 0, 0, 100, 0, 0, 49, 2, 1, 0, 1, 0, 0, 0, 0, 1, 0, 1, 0, 0, 0, 0, 16, 0, 0, 0, 0, 0, 3, 0, 35, 1, 18, 4, 0, 0, 21, 0, 0, 0, 38, 13, 45, 0, 0, 5, 6, 0, 0, 1, 0, 0, 133, 3, 48, 0, 0, 0, 0, 0, 0, 36, 0, 0, 0, 0, 0, 16, 0, 4, 0, 0, 0, 35, 0, 0, 13, 0, 12, 135, 0, 0, 58, 99, 0, 0, 36, 0, 0, 3, 0, 9, 0, 0, 0, 0, 9, 0, 0, 1, 8, 45, 29, 0, 2, 2, 5, 0, 0, 88, 1, 54, 0, 0, 0, 0, 0, 0, 71, 0, 79, 56, 0, 0, 7, 0, 0, 0, 0, 21, 0, 0, 0, 0, 0, 0, 41, 0, 36, 0, 0, 87, 66, 0, 0, 0, 0, 3, 13, 0, 0, 14, 0, 0, 30, 0, 212, 0, 0, 27, 88, 1, 3, 0, 4, 4, 0, 23, 0, 0, 1, 0, 0, 2, 0, 33, 0, 8, 0, 0, 4, 0, 0, 0, 0, 18, 53, 0, 1, 70, 0, 0, 0, 122, 69, 0, 22, 0, 0, 0, 0, 0, 0, 0, 4, 0, 11, 130, 13, 0
Private-Empire-ExxonMobil-and-American-Power-by-Steve-Coll-_z-lib.org_, 0, 0, 0, 64, 135, 0, 0, 0, 0, 101, 0, 293, 5, 0, 0, 0, 0, 0, 0, 0, 0, 0, 0, 22, 0, 0, 0, 0, 27, 3, 0, 0, 1, 0, 0, 0, 0, 96, 237, 0, 18, 0, 134, 5, 0, 0, 0, 15, 0, 0, 0, 81, 0, 0, 0, 4, 0, 0, 0, 3, 254, 0, 1, 0, 13, 0, 0, 403, 0, 21, 2, 0, 0, 0, 1, 0, 0, 65, 26, 0, 0, 0, 0, 0, 0, 176, 0, 26, 0, 78, 0, 0, 13, 7, 0, 0, 1, 3, 28, 6, 18, 0, 0, 72, 0, 0, 0, 0, 31, 0, 0, 20, 0, 0, 0, 84, 0, 13, 9, 0, 0, 85, 0, 0, 213, 196, 0, 0, 0, 0, 9, 0, 1, 0, 0, 0, 0, 0, 0, 150, 0, 0, 0, 2, 2, 46, 121, 0, 0, 0, 0, 0, 1, 0, 43, 68, 10, 0, 94, 11, 0, 42, 0, 0, 6, 0, 10, 3, 139, 59, 0, 0, 0, 49, 3, 0, 4, 0, 18, 45, 0, 143, 0, 106, 0, 0, 0, 11, 0, 10, 0, 0, 9, 12, 19, 0, 0, 0, 32, 0, 0, 7, 4, 147, 0, 9, 11, 1, 8, 14, 35, 162, 3, 0, 63, 0, 0, 0, 0, 14, 0, 0, 0, 0, 31, 0, 0, 0, 1, 0, 0, 2, 0, 0, 0, 0, 2, 94, 1, 0, 0, 46, 11, 0, 1, 0, 0, 0, 2, 0, 32, 0, 0, 81, 46, 0, 142, 0, 0, 0, 0, 10, 12, 1, 0, 0, 10, 0, 0, 47, 29, 0, 81, 6, 303, 17, 5, 5, 0, 0, 103, 0, 0, 0, 4, 0, 0, 0, 1, 27, 0, 59, 2, 27, 2, 19, 0, 26, 3, 39, 7, 98, 0, 0, 0, 372, 124, 0, 0, 2, 145, 0, 0, 0, 0, 29, 0, 15, 0, 2, 5, 0, 0, 18, 0, 0, 0, 0, 55, 0, 0, 323, 0, 43, 2, 0, 0, 0, 0, 0, 0, 0, 0, 225, 127, 0, 106, 1, 0, 58, 0, 242, 3, 0, 123, 1, 0, 97, 0, 0, 45, 0, 1, 0, 0, 2, 9, 0, 17, 4, 0, 0, 3, 4, 0, 0, 129, 15, 14, 62, 0, 0, 10, 1, 0, 39, 0, 1802, 4, 0, 16, 12, 0, 0, 0, 0, 0, 3, 0, 0, 0, 0, 0, 0, 0, 0, 0, 0, 0, 61, 14, 101, 0, 4, 4, 1, 0, 0, 0, 3, 0, 0, 40, 2, 0, 22, 0, 0, 58, 0, 0, 10, 0, 1, 121, 0, 1, 2, 34, 19, 0, 20, 0, 2, 49, 0, 0, 0, 0, 0, 0, 14, 3, 0, 25, 0, 77, 35, 0, 83, 0, 344, 0, 0, 87, 0, 107, 0, 0, 0, 0, 0, 0, 0, 0, 0, 0, 0, 0, 25, 0, 1, 3, 0, 0, 0, 150, 0, 0, 0, 0, 0, 0, 92, 0, 0, 1, 15, 29, 27, 0, 52, 0, 23, 0, 0, 0, 0, 0, 0, 0, 7, 7, 2, 133, 137, 0, 21, 4, 0, 5, 0, 45, 0, 0, 143, 0, 1, 0, 34, 37, 0, 4, 4, 0, 68, 1, 36, 0, 0, 26, 12, 0, 19, 0, 0, 3, 0, 0, 1, 0, 5, 591, 113, 0, 0, 196, 0, 0, 47, 5, 187, 0, 0, 0, 0, 0, 14, 0, 0, 24, 167, 0, 6, 0, 0, 0, 74, 0, 1, 150, 0, 0, 0, 7, 3, 0, 0, 5, 0, 0, 0, 144, 0, 0, 15, 0, 121, 0, 28, 0, 0, 0, 79, 0, 0, 0, 0, 3, 19, 125, 2, 105, 0, 73, 0, 0, 10, 1, 0, 0, 21, 1, 0, 57, 18, 0, 36, 2, 35, 2, 44, 0, 13, 0, 0, 273, 0, 0, 9, 0, 88, 0, 0, 28, 0, 65, 0, 0, 0, 0, 0, 82, 0, 0, 5, 0, 95, 0, 0, 3, 0, 35, 0, 2, 0, 3, 0, 5, 0, 0, 0, 0, 0, 33, 130, 1, 110, 0, 0, 1, 78, 0, 0, 32, 30, 2, 0, 44, 27, 0, 51, 0, 0, 17, 9, 0, 5, 0, 12, 26, 15, 0, 0, 2, 1, 100, 97, 0, 0, 0, 286, 0, 0, 89, 0, 73, 0, 0, 62, 0, 2, 1, 0, 0, 73, 0, 3, 0, 30, 0, 0, 63, 36, 0, 0, 0, 312, 1, 0, 0, 0, 0, 0, 0, 25, 4, 0, 6, 46, 0, 19, 29, 0, 0, 0, 1, 1, 0, 0, 18, 0, 0, 0, 0, 0, 0, 0, 165, 6, 0, 0, 0, 26, 6, 3, 883, 0, 0, 9, 48, 9, 0, 21, 2, 135, 85, 0, 63, 5, 0, 0, 0, 11, 0, 0, 265, 0, 0, 0, 0, 0, 0, 0, 0, 0, 0, 30, 0, 1, 0, 3, 0, 136, 0, 0, 0, 0, 53, 0, 0, 0, 34, 0, 97, 0, 0, 24, 40, 0, 160, 0, 28, 11, 0, 0, 1, 0, 0, 1, 0, 0, 10, 0, 5, 0, 1, 30, 40, 81, 109, 0, 8, 0, 0, 0, 64, 0, 0, 4, 0, 35, 0, 0, 0, 0, 3, 0, 0, 0, 0, 19, 1, 0, 0, 0, 6, 16, 4, 10, 8, 29, 20, 2, 0, 2, 12, 0, 11, 165, 34, 0, 13, 0, 0, 38, 0, 64, 1, 2, 10, 27, 48, 2, 0, 12, 0, 0, 0, 0, 0, 0, 0, 453, 0, 0, 0, 0, 45, 0, 0, 0, 0, 0, 2, 35, 0, 14, 0, 0, 0, 0, 8, 0, 154, 0, 0, 3, 368, 3, 0, 0, 41, 0, 0, 0, 0, 0, 0, 0, 3, 0, 0, 0, 11, 0, 2, 67, 1, 0, 116, 39, 0, 15, 0, 12, 0, 1, 1, 0, 0, 3, 0, 0, 123, 0, 0, 0, 90, 0, 0, 0, 63, 0, 0, 1, 74, 0, 0, 81, 0, 0, 4, 134, 0, 67, 5, 0, 0, 75, 0, 3, 2, 0, 0, 1, 1, 18, 52, 14, 0, 0, 23, 26, 10, 1, 0, 7, 40, 0, 15, 5, 0, 73, 102, 634, 10, 656, 0, 76, 29, 0, 0, 0, 2, 0, 0, 187, 0, 0, 112, 0, 0, 0, 0, 0, 0, 0, 0, 0, 2, 0, 92, 0, 0, 22, 100, 1, 0, 3, 0, 5, 0, 19, 0, 34, 6, 0, 2, 0, 0, 0, 35, 51, 0, 0, 44, 0, 54, 0, 0, 0, 7, 0, 0, 0, 0, 0, 105, 0, 0, 0, 1, 0, 76, 0, 19, 0, 4, 25, 193, 14, 0, 0, 93, 39, 34, 0, 0, 14, 0, 36, 0, 189, 0, 0, 14, 95, 124, 0, 0, 0, 1, 0, 7, 3, 117, 0, 0, 5, 0, 2, 37, 243, 3, 2, 414, 2, 0, 0, 0, 0, 0, 32, 34, 19, 2, 0, 0, 0, 0, 0, 10, 80, 3, 0, 1, 0, 15, 0, 0, 0, 0, 0, 0, 0, 0, 0, 0, 0, 0, 0, 296, 10, 1, 0, 3, 0, 0, 0, 1, 125, 0, 13, 0, 0, 0, 0, 0, 0, 0, 4, 3, 51, 0, 0, 85, 36, 0, 0, 2, 0, 0, 54, 0, 7, 18, 164, 1, 0, 0, 0, 0, 0, 0, 0, 4, 0, 0, 0, 0, 39, 85, 0, 52, 59, 12, 24, 0, 0, 0, 0, 2, 20, 0, 20, 3, 0, 0, 0, 11, 6, 0, 0, 87, 28, 0, 0, 49, 1, 0, 0, 0, 0, 59, 0, 0, 0, 2, 26, 5, 61, 53, 0, 0, 0, 0, 2, 2, 0, 30, 0, 0, 0, 39, 9, 0, 0, 0, 0, 1, 0, 0, 0, 0, 0, 1974, 0, 0, 0, 0, 0, 0, 0, 14, 6, 0, 0, 538, 18, 0, 0, 52, 0, 0, 0, 0, 10, 1, 6, 0, 0, 163, 0, 0, 173, 3, 0, 1, 2, 2, 0, 10, 0, 32, 0, 0, 0, 0, 55, 0, 0, 134, 2, 0, 0, 68, 2, 39, 52, 116, 0, 0, 0, 0, 0, 1, 3, 0, 0, 2, 3, 0, 1, 0, 0, 0, 0, 0, 0, 0, 110, 0, 0, 5, 162, 22, 56, 2, 0, 44, 41, 0, 0, 125, 20, 0, 0, 10, 17, 0, 0, 0, 0, 0, 6, 0, 322, 0, 22, 44, 0, 0, 54, 0, 0, 0, 7, 0, 47, 0, 24, 0, 188, 0, 51, 0, 63, 123, 11, 0, 0, 75, 0, 0, 0, 0, 6, 149, 0, 1, 20, 201, 0, 42, 35, 6, 26, 0, 0, 5, 24, 0, 69, 0, 7, 9, 0, 0, 7, 0, 53, 2, 0, 0, 0, 14, 0, 0, 0, 101, 44, 7, 0, 0, 56, 0, 102, 6, 0, 14, 1, 3, 0, 0, 0, 0, 14, 0, 0, 14, 0, 0, 2, 0, 302, 0, 3, 0, 0, 5, 41, 9, 0, 0, 27, 0, 0, 4, 12, 10, 11, 41, 9, 0, 0, 83, 0, 250, 31, 29, 0, 0, 0, 0, 0, 14, 0, 0, 0, 99, 1, 38, 0, 0, 0, 70, 0, 0, 2, 0, 0, 20, 1, 7, 0, 47, 0, 0, 0, 0, 2, 0, 1, 0, 56, 1, 0, 0, 0, 0, 0, 0, 0, 0, 0, 80, 0, 0, 4, 14, 3, 0, 31, 0, 0, 0, 0, 0, 0, 8, 0, 0, 0, 0, 52, 0, 0, 4, 1, 0, 4, 11, 18, 125, 226, 51, 0, 0, 56, 2, 0, 4, 84, 29, 70, 0, 1, 40, 7, 0, 0, 23, 0, 0, 88, 7, 0, 0, 0, 0, 0, 0, 0, 93, 0, 2, 0, 0, 0, 48, 1, 7, 0, 0, 0, 39, 0, 0, 15, 2, 9, 106, 0, 0, 106, 77, 0, 0, 1, 0, 0, 12, 2, 45, 3, 0, 0, 0, 34, 0, 0, 0, 0, 79, 59, 0, 0, 0, 57, 0, 0, 75, 44, 23, 0, 0, 0, 0, 0, 0, 153, 145, 106, 39, 0, 0, 0, 0, 0, 9, 0, 15, 2, 0, 1, 2, 0, 0, 68, 0, 61, 0, 0, 0, 14, 0, 0, 0, 1, 1, 38, 1, 0, 76, 3, 0, 29, 1, 0, 0, 0, 173, 218, 0, 9, 199, 52, 26, 0, 4, 9, 0, 14, 0, 0, 3, 0, 54, 4, 16, 0, 0, 4, 0, 0, 0, 0, 23, 0, 0, 16, 559, 0, 0, 0, 27, 160, 0, 39, 0, 3, 59, 0, 0, 0, 0, 12, 0, 53, 49, 54, 28
Prophets of war Lockheed Martin and the making of the military-industrial complex by Lockheed Martin.Hartung- William D (z-lib.org), 0, 0, 0, 87, 38, 0, 0, 0, 0, 25, 0, 25, 1, 0, 0, 22, 2, 24, 0, 0, 0, 0, 0, 12, 4, 0, 0, 0, 6, 0, 0, 0, 6, 0, 0, 0, 0, 1, 58, 0, 12, 0, 184, 0, 0, 0, 0, 7, 0, 0, 0, 20, 0, 0, 0, 4, 0, 0, 0, 0, 62, 0, 0, 0, 54, 0, 0, 80, 0, 3, 0, 0, 0, 0, 1, 0, 0, 0, 3, 0, 0, 0, 0, 0, 0, 1, 0, 53, 0, 38, 0, 0, 22, 0, 0, 0, 0, 2, 6, 39, 4, 0, 0, 0, 0, 0, 0, 2, 1, 0, 0, 9, 0, 1, 0, 21, 0, 1, 187, 0, 0, 1, 0, 0, 70, 44, 16, 0, 0, 0, 3, 0, 0, 0, 0, 0, 0, 0, 0, 220, 0, 0, 0, 0, 0, 19, 57, 0, 0, 0, 0, 0, 0, 0, 3, 13, 35, 0, 38, 2, 1, 8, 0, 0, 2, 0, 5, 2, 18, 18, 0, 0, 0, 10, 4, 0, 5, 0, 5, 23, 12, 57, 0, 5, 0, 0, 0, 8, 0, 8, 0, 0, 6, 2, 9, 42, 0, 0, 20, 0, 1, 7, 0, 43, 0, 1, 6, 0, 1, 6, 9, 170, 0, 0, 23, 0, 0, 0, 0, 2, 0, 0, 0, 0, 3, 0, 0, 0, 0, 0, 0, 0, 0, 0, 0, 0, 5, 0, 3, 0, 0, 18, 34, 0, 2, 0, 0, 0, 4, 0, 11, 0, 0, 8, 8, 0, 229, 1, 0, 0, 0, 5, 2, 0, 0, 0, 17, 0, 0, 29, 13, 0, 23, 2, 51, 1, 1, 0, 4, 0, 8, 0, 0, 0, 1, 0, 0, 0, 1, 3, 0, 30, 2, 8, 0, 23, 0, 17, 0, 19, 38, 29, 0, 0, 0, 66, 58, 0, 0, 0, 51, 0, 0, 0, 3, 5, 0, 13, 0, 0, 12, 20, 0, 37, 0, 0, 0, 0, 13, 0, 0, 5, 18, 21, 1, 0, 0, 0, 0, 0, 1, 0, 0, 0, 0, 0, 51, 0, 0, 19, 0, 7, 3, 0, 4, 0, 0, 40, 0, 0, 11, 0, 0, 0, 0, 0, 4, 1, 11, 0, 0, 0, 0, 2, 0, 0, 22, 13, 2, 57, 0, 0, 10, 0, 0, 12, 0, 0, 2, 0, 0, 7, 0, 0, 0, 0, 0, 47, 0, 0, 0, 0, 0, 0, 0, 0, 0, 1, 0, 26, 1, 7, 35, 0, 4, 0, 0, 0, 0, 0, 0, 0, 0, 1, 0, 233, 0, 1, 13, 0, 0, 1, 0, 0, 18, 0, 0, 1, 6, 146, 1, 49, 0, 0, 19, 0, 0, 0, 0, 0, 0, 58, 45, 1, 6, 0, 34, 2, 0, 4, 0, 134, 0, 0, 253, 0, 20, 0, 0, 0, 2, 0, 0, 0, 0, 0, 0, 0, 0, 3, 0, 0, 0, 0, 0, 0, 83, 0, 0, 0, 0, 0, 0, 0, 0, 0, 1, 80, 251, 8, 0, 143, 0, 8, 0, 0, 0, 0, 0, 0, 0, 0, 4, 0, 41, 16, 0, 5, 0, 1, 0, 0, 40, 0, 0, 47, 0, 3, 0, 5, 4, 93, 2, 0, 0, 7, 0, 6, 0, 0, 3, 2, 0, 4, 0, 0, 0, 0, 0, 1, 21, 2, 1, 0, 0, 0, 13, 0, 0, 15, 3, 0, 0, 0, 0, 25, 0, 8, 0, 0, 17, 0, 0, 7, 0, 0, 6, 33, 0, 1, 6, 0, 0, 0, 7, 0, 0, 0, 1, 0, 0, 32, 45, 0, 0, 5, 0, 19, 0, 14, 0, 0, 0, 35, 0, 0, 0, 0, 2, 3, 21, 0, 13, 0, 44, 0, 0, 13, 2, 0, 0, 6, 0, 0, 24, 0, 0, 7, 1, 6, 0, 24, 0, 0, 0, 0, 53, 1, 0, 3, 0, 9, 0, 0, 31, 0, 19, 0, 0, 0, 0, 0, 8, 0, 0, 0, 0, 70, 0, 1, 0, 0, 27, 0, 1, 0, 3, 0, 3, 0, 0, 0, 0, 0, 5, 19, 0, 3, 0, 0, 0, 108, 0, 0, 21, 9, 0, 0, 7, 11, 0, 63, 0, 0, 2, 16, 15, 0, 0, 35, 24, 0, 36, 0, 0, 0, 22, 23, 0, 0, 0, 105, 0, 0, 42, 0, 10, 0, 0, 0, 0, 0, 0, 0, 0, 23, 0, 0, 0, 14, 0, 0, 19, 21, 0, 0, 0, 0, 0, 0, 0, 0, 34, 0, 0, 20, 1, 0, 5, 173, 0, 2, 8, 0, 0, 0, 0, 1, 0, 0, 41, 2, 0, 0, 0, 19, 0, 0, 18, 20, 1, 0, 0, 10, 9, 5, 31, 0, 0, 2, 13, 8, 0, 0, 2, 36, 7, 0, 38, 6, 0, 0, 0, 11, 0, 0, 96, 0, 0, 0, 0, 0, 0, 0, 0, 0, 0, 46, 0, 1, 0, 0, 0, 11, 0, 0, 0, 0, 4, 0, 0, 0, 7, 0, 10, 0, 0, 8, 22, 0, 31, 0, 4, 1, 0, 1, 4, 1, 0, 1, 41, 0, 7, 0, 0, 0, 0, 12, 13, 11, 7, 0, 2, 0, 0, 0, 2, 0, 0, 0, 0, 5, 0, 0, 0, 83, 0, 0, 0, 0, 0, 4, 3, 0, 0, 0, 0, 1, 0, 0, 0, 21, 35, 0, 0, 0, 49, 0, 7, 35, 8, 0, 8, 0, 0, 6, 1, 14, 0, 0, 1, 8, 4, 1, 0, 2, 0, 0, 0, 1, 0, 0, 0, 139, 0, 0, 0, 0, 86, 0, 0, 0, 0, 0, 0, 2, 0, 2, 30, 0, 0, 0, 3, 0, 55, 0, 0, 0, 64, 0, 0, 0, 5, 0, 0, 0, 0, 0, 0, 0, 1, 0, 0, 0, 2, 1, 0, 42, 2, 0, 8, 86, 0, 4, 0, 5, 0, 2, 0, 0, 0, 0, 1, 0, 23, 0, 0, 0, 8, 0, 0, 0, 10, 0, 0, 0, 35, 0, 0, 22, 0, 0, 0, 14, 0, 31, 10, 0, 0, 0, 1, 0, 0, 0, 0, 11, 1, 4, 30, 7, 0, 0, 0, 18, 0, 0, 0, 1, 5, 0, 1, 0, 0, 9, 0, 0, 0, 0, 0, 35, 4, 0, 0, 0, 2, 28, 0, 0, 3, 0, 69, 0, 0, 0, 3, 0, 0, 1, 0, 0, 0, 0, 90, 0, 0, 12, 1, 0, 0, 2, 0, 16, 0, 2, 2, 21, 1, 0, 0, 0, 0, 0, 18, 9, 0, 0, 51, 0, 2, 0, 0, 0, 7, 0, 0, 0, 0, 0, 21, 0, 0, 0, 0, 0, 26, 0, 11, 0, 1, 2, 48, 10, 0, 1, 22, 12, 2, 0, 0, 0, 0, 11, 0, 46, 0, 0, 0, 6, 25, 0, 0, 1, 0, 0, 1, 0, 66, 0, 0, 2, 0, 3, 13, 3, 6, 0, 51, 2, 0, 0, 0, 4, 0, 11, 10, 24, 0, 0, 0, 0, 0, 0, 2, 86, 0, 0, 2, 0, 21, 0, 0, 0, 0, 0, 0, 0, 0, 0, 0, 0, 0, 0, 97, 3, 0, 0, 1, 0, 0, 0, 0, 17, 0, 10, 0, 0, 746, 0, 0, 0, 19, 0, 0, 28, 0, 0, 22, 0, 0, 0, 1, 0, 0, 26, 0, 4, 0, 93, 0, 0, 0, 0, 0, 0, 0, 0, 6, 0, 0, 0, 0, 50, 35, 0, 20, 6, 3, 1, 0, 0, 0, 0, 0, 2, 0, 5, 1, 0, 0, 0, 35, 0, 0, 0, 3, 30, 0, 0, 38, 3, 0, 0, 0, 0, 95, 0, 0, 0, 0, 8, 0, 30, 27, 0, 0, 0, 0, 0, 149, 0, 11, 0, 0, 0, 0, 8, 0, 0, 0, 0, 0, 1, 44, 0, 0, 5, 8, 0, 0, 0, 0, 28, 0, 0, 4, 2, 0, 0, 422, 26, 0, 0, 9, 0, 0, 0, 1, 30, 1, 1, 0, 0, 12, 1, 0, 25, 2, 0, 1, 1, 2, 0, 1, 0, 12, 19, 0, 0, 0, 29, 0, 0, 68, 0, 0, 29, 90, 2, 16, 28, 24, 0, 0, 0, 0, 1, 0, 1, 0, 1, 9, 0, 0, 0, 0, 0, 1, 0, 0, 1, 0, 14, 0, 0, 2, 26, 6, 22, 0, 0, 11, 3, 0, 0, 19, 6, 0, 0, 0, 2, 0, 0, 0, 0, 0, 6, 0, 67, 0, 8, 7, 0, 0, 5, 0, 0, 0, 0, 1, 25, 0, 5, 0, 26, 0, 9, 0, 12, 93, 2, 0, 0, 0, 0, 0, 0, 0, 9, 11, 0, 0, 31, 0, 0, 10, 6, 8, 10, 0, 0, 0, 3, 0, 39, 0, 0, 0, 4, 0, 0, 0, 16, 11, 0, 0, 0, 2, 0, 0, 0, 13, 25, 3, 0, 0, 7, 0, 99, 1, 0, 0, 0, 1, 0, 0, 0, 0, 0, 1, 0, 2, 0, 0, 0, 0, 12, 0, 5, 0, 0, 0, 16, 4, 0, 0, 2, 0, 0, 0, 0, 2, 110, 33, 0, 0, 0, 49, 0, 100, 1, 3, 0, 0, 0, 0, 0, 2, 0, 0, 0, 11, 2, 12, 0, 0, 0, 62, 0, 0, 1, 0, 0, 6, 0, 6, 0, 19, 0, 0, 0, 0, 0, 0, 0, 0, 5, 1, 0, 0, 2, 0, 4, 0, 0, 0, 0, 63, 20, 0, 1, 1, 10, 0, 8, 0, 0, 0, 0, 0, 0, 0, 7, 0, 0, 0, 5, 0, 0, 0, 38, 0, 3, 8, 13, 33, 36, 3, 0, 0, 18, 0, 0, 0, 21, 13, 28, 0, 0, 12, 0, 2, 0, 1, 0, 0, 48, 4, 0, 0, 0, 0, 0, 0, 0, 8, 0, 2, 0, 0, 0, 17, 0, 1, 0, 0, 0, 32, 1, 0, 2, 2, 0, 56, 0, 0, 167, 11, 0, 0, 0, 0, 0, 1, 0, 96, 22, 0, 0, 1, 1, 0, 8, 0, 0, 6, 28, 0, 0, 0, 5, 0, 0, 39, 0, 3, 0, 0, 0, 1, 0, 0, 29, 1, 11, 9, 0, 0, 0, 0, 0, 9, 0, 5, 0, 0, 0, 2, 0, 0, 8, 0, 37, 0, 0, 0, 6, 0, 0, 0, 0, 1, 4, 0, 0, 24, 1, 0, 15, 0, 0, 4, 0, 97, 28, 0, 9, 67, 5, 7, 0, 337, 21, 0, 36, 0, 0, 5, 0, 15, 0, 4, 0, 0, 4, 0, 0, 0, 0, 18, 0, 0, 8, 40, 0, 0, 1, 0, 47, 0, 21, 0, 1, 0, 1, 0, 0, 0, 0, 0, 17, 40, 6, 11
Renewing Unilever Transformation and Tradition by Geoffrey Jones (z-lib.org), 0, 0, 0, 37, 80, 0, 0, 0, 0, 39, 1, 2, 0, 0, 0, 1, 5, 0, 0, 0, 0, 0, 0, 23, 1, 0, 0, 0, 9, 1, 0, 0, 1, 0, 0, 0, 0, 55, 84, 0, 14, 0, 100, 0, 0, 0, 0, 342, 0, 0, 0, 129, 0, 0, 0, 0, 0, 0, 0, 0, 51, 17, 0, 0, 1, 0, 0, 217, 0, 4, 0, 7, 0, 0, 0, 0, 0, 0, 32, 0, 0, 0, 0, 0, 0, 5, 0, 2, 0, 224, 0, 250, 4, 1, 0, 0, 0, 0, 0, 0, 2, 0, 0, 0, 0, 0, 0, 0, 50, 0, 0, 12, 0, 0, 0, 56, 0, 4, 1, 0, 0, 0, 0, 0, 61, 22, 0, 0, 0, 0, 12, 0, 0, 0, 0, 0, 0, 0, 0, 1, 0, 13, 0, 0, 0, 35, 41, 0, 0, 0, 0, 0, 7, 0, 2, 76, 0, 0, 102, 37, 0, 10, 0, 0, 0, 0, 7, 0, 16, 5, 0, 0, 0, 55, 0, 0, 0, 2392, 21, 103, 0, 26, 0, 166, 0, 0, 0, 6, 0, 2, 0, 0, 10, 55, 3, 1, 2, 1, 12, 0, 0, 1, 0, 147, 0, 0, 5, 0, 0, 47, 49, 13, 0, 0, 42, 0, 0, 0, 0, 0, 0, 0, 0, 0, 1, 0, 0, 0, 179, 0, 0, 0, 0, 0, 0, 0, 29, 0, 1, 2, 0, 38, 30, 0, 0, 0, 0, 2, 0, 0, 20, 0, 154, 0, 34, 0, 29, 7, 0, 0, 0, 11, 1, 1, 0, 0, 0, 8, 0, 5, 16, 0, 128, 0, 4, 1, 0, 2, 1, 0, 26, 0, 0, 0, 0, 0, 0, 0, 2, 106, 5, 24, 0, 3, 0, 7, 0, 55, 0, 58, 0, 49, 0, 0, 0, 347, 72, 0, 0, 0, 77, 0, 0, 0, 0, 91, 0, 21, 0, 33, 48, 0, 0, 69, 0, 0, 0, 0, 4, 0, 0, 7, 0, 1, 11, 0, 3, 1, 0, 0, 0, 0, 0, 0, 0, 0, 80, 2, 0, 194, 0, 6, 3, 5, 351, 145, 0, 126, 0, 0, 16, 0, 0, 13, 0, 3, 4, 0, 69, 0, 0, 0, 0, 3, 0, 3, 53, 0, 2, 247, 0, 0, 4, 0, 0, 10, 6, 0, 3, 0, 4, 14, 0, 0, 0, 0, 0, 0, 0, 0, 0, 0, 0, 0, 2, 0, 0, 0, 0, 16, 148, 1, 0, 0, 37, 0, 0, 0, 0, 0, 0, 0, 0, 0, 0, 0, 0, 0, 26, 0, 0, 0, 0, 0, 1, 0, 0, 1, 26, 1, 111, 33, 0, 0, 37, 0, 0, 0, 0, 0, 0, 0, 0, 0, 2, 0, 146, 140, 0, 1, 0, 222, 0, 7, 0, 0, 14, 0, 0, 1, 0, 0, 2, 0, 0, 0, 0, 0, 0, 4, 0, 1, 8, 0, 0, 0, 14, 0, 0, 0, 0, 0, 0, 47, 0, 0, 0, 3, 3, 4, 0, 0, 0, 72, 0, 0, 0, 0, 0, 0, 0, 0, 26, 0, 162, 10, 0, 0, 0, 0, 0, 0, 74, 0, 0, 43, 0, 1, 0, 1, 18, 0, 0, 0, 0, 2, 39, 41, 0, 0, 6, 47, 2, 0, 0, 0, 0, 0, 0, 6, 0, 9, 1, 0, 54, 0, 184, 0, 0, 9, 1, 2, 0, 0, 0, 0, 0, 288, 73, 0, 132, 0, 0, 11, 0, 0, 0, 64, 3, 0, 138, 0, 0, 0, 0, 2, 0, 0, 0, 0, 0, 5, 23, 0, 2, 27, 2, 44, 6, 1, 0, 0, 6, 43, 0, 0, 0, 0, 2, 63, 37, 4, 8, 1, 10, 0, 0, 46, 4, 0, 0, 18, 0, 0, 10, 14, 0, 50, 1, 4, 0, 23, 0, 1, 6, 0, 191, 160, 0, 1, 0, 53, 3, 0, 59, 0, 142, 3, 0, 0, 0, 0, 3, 0, 0, 0, 0, 281, 0, 0, 0, 0, 117, 0, 1, 0, 6, 0, 0, 0, 4, 0, 0, 0, 42, 42, 0, 0, 0, 0, 0, 47, 0, 0, 6, 5, 0, 0, 6, 171, 0, 38, 0, 0, 60, 16, 0, 0, 0, 0, 24, 30, 0, 0, 0, 0, 12, 48, 0, 1, 0, 11, 0, 0, 38, 0, 28, 0, 0, 0, 0, 56, 39, 17, 0, 71, 0, 0, 30, 18, 0, 0, 44, 53, 0, 0, 0, 0, 30, 0, 0, 0, 0, 0, 0, 18, 1, 0, 1, 2, 0, 5, 11, 0, 0, 0, 0, 0, 1, 0, 3, 0, 0, 0, 0, 0, 0, 1, 67, 0, 4, 0, 0, 4, 0, 2, 36, 0, 0, 4, 4, 0, 0, 16, 0, 33, 14, 0, 124, 14, 0, 0, 0, 0, 0, 0, 110, 0, 0, 0, 0, 0, 0, 0, 0, 0, 1, 39, 1, 0, 0, 0, 0, 0, 2, 0, 0, 0, 18, 0, 0, 0, 6, 0, 172, 0, 0, 25, 29, 0, 148, 7, 17, 16, 0, 0, 0, 0, 0, 2, 0, 0, 0, 0, 7, 0, 1, 30, 56, 41, 8, 1, 3, 0, 0, 0, 32, 0, 11, 0, 0, 19, 0, 0, 0, 10, 25, 0, 0, 0, 0, 32, 8, 0, 0, 0, 2, 33, 3, 4, 4, 51, 5, 0, 0, 0, 0, 0, 1, 82, 98, 0, 104, 0, 0, 8, 0, 8, 197, 0, 23, 9, 48, 0, 0, 3, 0, 0, 0, 0, 0, 0, 0, 140, 0, 0, 1, 0, 0, 0, 0, 0, 0, 0, 0, 13, 0, 2, 0, 0, 0, 0, 11, 5, 217, 0, 0, 3, 1, 0, 0, 13, 123, 0, 0, 0, 0, 0, 0, 0, 0, 0, 0, 1, 0, 0, 0, 6, 0, 0, 151, 0, 0, 0, 0, 13, 0, 0, 0, 0, 0, 1, 0, 0, 59, 0, 0, 0, 47, 0, 0, 0, 30, 0, 0, 0, 50, 0, 0, 24, 0, 0, 0, 182, 0, 173, 2, 0, 0, 19, 0, 2, 1, 0, 0, 0, 0, 17, 98, 24, 0, 0, 0, 38, 1, 0, 0, 118, 43, 0, 33, 4, 0, 42, 0, 1, 0, 0, 0, 31, 26, 0, 0, 0, 1, 0, 0, 0, 15, 0, 142, 0, 0, 0, 0, 0, 0, 0, 0, 0, 2, 0, 47, 0, 0, 28, 1, 0, 0, 46, 0, 0, 0, 18, 3, 39, 1, 0, 0, 0, 0, 0, 25, 0, 0, 0, 88, 0, 6, 0, 0, 0, 0, 0, 0, 0, 0, 0, 44, 0, 0, 0, 0, 0, 53, 0, 25, 0, 0, 8, 695, 184, 0, 0, 64, 74, 0, 0, 0, 0, 0, 115, 0, 51, 0, 0, 0, 104, 25, 0, 0, 0, 0, 0, 32, 0, 20, 0, 0, 0, 0, 6, 5, 8, 8, 3, 65, 8, 0, 0, 0, 0, 0, 14, 18, 124, 6, 0, 0, 0, 0, 0, 0, 138, 0, 0, 1, 11, 4, 0, 0, 59, 0, 0, 0, 0, 0, 0, 0, 1, 0, 0, 1, 83, 4, 0, 0, 0, 0, 0, 1, 336, 0, 15, 0, 0, 0, 0, 0, 0, 0, 46, 1, 117, 4, 0, 14, 1, 0, 0, 2, 1, 0, 122, 0, 80, 643, 34, 125, 0, 0, 0, 0, 0, 0, 0, 126, 0, 0, 0, 0, 94, 48, 0, 39, 3, 9, 2, 0, 0, 0, 0, 12, 4, 0, 35, 15, 0, 0, 0, 8, 29, 0, 0, 3, 23, 0, 0, 0, 22, 0, 5, 0, 0, 2, 0, 0, 1, 3, 1, 1, 1, 741, 0, 0, 0, 1, 0, 1, 0, 6, 0, 0, 0, 0, 14, 0, 0, 0, 0, 0, 0, 0, 1, 0, 0, 171, 0, 0, 0, 1, 0, 0, 0, 0, 3, 0, 0, 825, 7, 0, 0, 20, 0, 3, 1, 0, 1, 3, 0, 0, 0, 7, 0, 1, 16, 3, 0, 0, 0, 0, 0, 2, 0, 7, 0, 0, 0, 0, 0, 0, 0, 71, 0, 0, 0, 32, 0, 0, 46, 9, 0, 0, 0, 0, 1, 0, 0, 0, 5, 1, 0, 0, 0, 0, 0, 4, 0, 0, 0, 0, 51, 0, 0, 0, 62, 87, 0, 0, 0, 23, 1, 0, 0, 27, 17, 8, 0, 0, 41, 0, 0, 0, 0, 0, 3, 0, 131, 0, 22, 19, 0, 0, 35, 0, 0, 0, 21, 0, 246, 0, 1, 0, 172, 0, 2, 0, 17, 236, 1, 0, 0, 0, 0, 0, 0, 0, 56, 90, 0, 0, 189, 0, 0, 100, 19, 8, 12, 0, 0, 3, 7, 0, 26, 0, 1, 0, 2, 0, 2, 0, 27, 0, 0, 0, 0, 1, 10, 0, 0, 218, 49, 0, 0, 0, 4, 0, 171, 7, 0, 0, 0, 3, 0, 0, 0, 0, 4, 1, 0, 1, 0, 0, 0, 0, 20, 0, 3, 0, 0, 1, 265, 0, 0, 0, 17, 0, 0, 0, 0, 3, 1, 10, 0, 1, 0, 5, 0, 794, 221, 19, 1, 0, 0, 0, 0, 1, 0, 0, 0, 13, 2, 17, 0, 1, 0, 9, 0, 0, 0, 0, 0, 21, 0, 1, 0, 7, 0, 0, 0, 0, 0, 0, 4, 0, 14, 0, 0, 0, 2, 0, 0, 0, 0, 0, 0, 206, 0, 0, 0, 6, 68, 0, 0, 0, 0, 0, 0, 0, 0, 1, 1, 2, 0, 19, 112, 10, 0, 0, 0, 0, 6, 3, 199, 0, 72, 41, 0, 0, 4, 0, 0, 0, 27, 73, 47, 0, 0, 1, 1, 0, 0, 5, 0, 0, 17, 2, 0, 0, 0, 0, 0, 0, 0, 23, 0, 1, 0, 0, 0, 2, 0, 7, 1, 0, 0, 2, 0, 0, 2, 0, 1, 30, 0, 0, 111, 39, 0, 0, 0, 0, 0, 2, 0, 4, 0, 0, 0, 0, 0, 0, 0, 0, 0, 71, 70, 0, 0, 0, 8, 0, 1, 47, 1, 1, 0, 0, 0, 0, 0, 0, 80, 0, 19, 9, 0, 0, 0, 0, 0, 37, 0, 2, 2, 0, 0, 0, 0, 0, 5, 0, 39, 0, 0, 0, 11, 0, 0, 0, 0, 22, 10, 0, 0, 40, 1, 0, 22, 0, 0, 0, 0, 49, 149, 0, 3, 0, 19, 1, 0, 1, 1, 0, 4, 0, 0, 0, 0, 33, 0, 6, 0, 0, 18, 0, 0, 0, 0, 7, 0, 0, 4, 72, 0, 0, 0, 1, 40, 0, 35, 0, 0, 0, 2, 59, 0, 0, 19, 17, 7, 67, 20, 0
Rising-Tide-Lessons-from-165-Years-of-Brand-Building-at-Procter-Gamble-by-Davis-Dyer_-Frederick-Dalz, 0, 0, 0, 20, 87, 0, 0, 0, 0, 25, 0, 4, 1, 0, 0, 3, 6, 0, 0, 0, 0, 0, 0, 24, 64, 0, 0, 0, 18, 0, 0, 0, 2, 0, 0, 0, 163, 4, 52, 0, 7, 0, 79, 0, 0, 0, 0, 112, 0, 0, 0, 32, 0, 0, 0, 0, 0, 0, 0, 0, 52, 0, 0, 0, 1, 0, 0, 176, 0, 2, 0, 48, 0, 0, 1, 0, 0, 0, 16, 0, 0, 0, 0, 0, 0, 52, 0, 20, 0, 167, 0, 217, 23, 0, 0, 0, 0, 0, 10, 1, 0, 0, 0, 0, 0, 0, 0, 0, 8, 0, 0, 16, 1, 2, 0, 112, 0, 511, 0, 0, 0, 0, 0, 0, 94, 71, 0, 0, 0, 0, 4, 45, 0, 0, 0, 0, 0, 0, 0, 11, 0, 0, 1, 0, 0, 41, 73, 0, 0, 0, 0, 0, 3, 0, 28, 154, 1, 0, 118, 59, 1, 23, 0, 0, 10, 0, 7, 4, 5, 1, 0, 0, 0, 112, 0, 0, 1, 29, 7, 22, 0, 57, 0, 94, 0, 0, 37, 8, 0, 4, 0, 0, 4, 28, 15, 2, 0, 1, 45, 0, 0, 0, 0, 183, 0, 0, 16, 2, 5, 119, 31, 15, 2, 0, 10, 0, 0, 0, 0, 2, 0, 0, 0, 0, 26, 0, 0, 0, 11, 0, 0, 0, 0, 0, 0, 0, 62, 0, 0, 0, 0, 60, 123, 0, 0, 0, 0, 0, 1, 0, 155, 0, 0, 0, 39, 0, 82, 1, 0, 0, 0, 70, 5, 0, 0, 48, 0, 166, 0, 4, 85, 0, 117, 2, 3, 4, 0, 0, 0, 0, 48, 0, 0, 45, 4, 0, 0, 0, 4, 20, 0, 27, 5, 0, 0, 16, 0, 115, 0, 20, 1, 139, 0, 0, 0, 117, 77, 0, 0, 0, 38, 0, 0, 0, 2, 50, 0, 41, 0, 16, 40, 0, 0, 29, 0, 0, 0, 0, 17, 0, 0, 19, 0, 5, 1, 0, 0, 0, 0, 0, 1, 0, 0, 0, 0, 0, 81, 1, 0, 1, 0, 5, 5, 52, 280, 0, 0, 43, 0, 0, 22, 0, 16, 23, 0, 0, 7, 0, 115, 7, 0, 0, 0, 15, 0, 28, 53, 4, 0, 216, 0, 0, 7, 0, 0, 94, 0, 0, 5, 0, 1, 11, 0, 0, 0, 0, 0, 0, 0, 0, 0, 0, 0, 0, 0, 0, 0, 0, 0, 20, 91, 0, 0, 0, 105, 0, 0, 0, 0, 0, 0, 0, 1, 1, 0, 4, 0, 0, 47, 0, 0, 0, 0, 1, 2, 0, 1, 2, 16, 2, 0, 55, 0, 1, 27, 0, 1, 0, 0, 0, 0, 2, 1, 0, 7, 0, 104, 25, 0, 1, 0, 276, 0, 60, 2, 0, 53, 0, 0, 0, 0, 0, 2, 0, 0, 0, 0, 0, 0, 100, 0, 0, 5, 1, 0, 0, 12, 0, 0, 0, 0, 0, 0, 0, 0, 0, 1, 4, 16, 5, 0, 0, 0, 291, 0, 0, 0, 0, 57, 0, 0, 1, 3, 0, 149, 24, 0, 2, 0, 0, 0, 0, 15, 0, 0, 178, 0, 1, 0, 6, 17, 0, 0, 0, 0, 2, 14, 13, 0, 1, 5, 11, 0, 0, 0, 0, 0, 0, 0, 0, 0, 6, 1, 0, 105, 0, 66, 0, 0, 20, 10, 0, 0, 0, 0, 0, 0, 69, 5, 0, 23, 0, 0, 22, 0, 0, 5, 51, 2, 1, 7, 0, 0, 0, 11, 1, 0, 0, 0, 0, 0, 2, 67, 0, 71, 24, 0, 107, 0, 13, 0, 0, 9, 33, 0, 0, 0, 0, 0, 2, 79, 6, 10, 0, 21, 0, 0, 36, 9, 0, 0, 20, 2, 0, 39, 1, 0, 95, 4, 7, 0, 45, 0, 1, 0, 0, 159, 0, 0, 4, 0, 68, 175, 0, 26, 0, 126, 14, 0, 0, 1, 0, 1, 0, 1, 0, 0, 49, 0, 0, 0, 0, 176, 0, 2, 0, 5, 0, 4, 0, 0, 0, 0, 0, 10, 61, 1, 0, 0, 0, 0, 45, 0, 0, 24, 6, 0, 0, 0, 1, 0, 77, 0, 0, 2, 7, 2, 0, 0, 0, 143, 46, 0, 0, 0, 0, 177, 57, 0, 0, 0, 96, 0, 0, 37, 0, 49, 0, 0, 0, 0, 63, 82, 0, 0, 51, 0, 0, 0, 53, 0, 0, 35, 216, 0, 0, 0, 0, 0, 0, 0, 0, 1, 0, 0, 6, 6, 0, 2, 59, 0, 3, 155, 0, 0, 0, 2, 0, 0, 0, 5, 0, 0, 0, 0, 0, 0, 0, 30, 0, 0, 0, 0, 12, 2, 1, 21, 0, 0, 25, 29, 1, 0, 17, 40, 33, 111, 0, 58, 11, 0, 3, 0, 8, 0, 0, 110, 0, 0, 0, 0, 0, 0, 0, 0, 0, 43, 56, 0, 0, 0, 4, 0, 3, 2, 0, 0, 0, 4, 0, 0, 0, 1, 0, 36, 0, 0, 21, 23, 0, 79, 64, 9, 34, 0, 0, 0, 1, 0, 0, 0, 0, 0, 0, 0, 0, 1, 15, 82, 38, 68, 0, 4, 0, 0, 0, 43, 0, 0, 0, 0, 11, 0, 0, 0, 2, 3, 0, 4, 0, 0, 26, 1, 3, 0, 0, 5, 121, 1, 1, 0, 39, 4, 0, 0, 0, 1, 0, 4, 135, 110, 0, 26, 1, 0, 22, 0, 12, 11, 0, 46, 5, 72, 0, 0, 2, 0, 0, 0, 0, 0, 0, 0, 51, 0, 0, 0, 0, 0, 0, 0, 0, 0, 0, 2, 62, 0, 5, 0, 0, 0, 0, 6, 15, 74, 0, 0, 3, 0, 0, 0, 1, 164, 0, 0, 0, 0, 0, 0, 0, 1, 0, 0, 2, 3, 4, 0, 60, 0, 0, 141, 4, 0, 10, 0, 82, 0, 2, 0, 0, 0, 12, 0, 0, 34, 0, 27, 0, 34, 0, 0, 0, 35, 0, 0, 2, 107, 0, 0, 57, 0, 0, 23, 192, 0, 151, 0, 0, 0, 0, 0, 0, 0, 0, 0, 0, 0, 30, 27, 12, 0, 0, 0, 78, 2, 1, 0, 209, 43, 3, 8, 1, 0, 29, 0, 0, 0, 1, 0, 45, 6, 0, 0, 0, 1, 0, 0, 0, 19, 0, 70, 0, 0, 0, 0, 0, 0, 0, 0, 0, 2, 0, 34, 0, 0, 14, 10, 0, 0, 5, 0, 1, 0, 77, 1, 24, 0, 0, 3, 0, 0, 0, 19, 0, 0, 0, 65, 0, 5, 0, 0, 0, 4, 0, 0, 0, 0, 0, 12, 0, 0, 0, 0, 0, 26, 0, 48, 0, 4, 5, 698, 237, 0, 0, 21, 49, 1, 0, 0, 2, 0, 113, 5, 29, 0, 0, 0, 52, 13, 0, 0, 0, 0, 0, 8, 0, 37, 0, 0, 0, 0, 2, 28, 5, 41, 2, 149, 15, 0, 0, 23, 3, 0, 20, 8, 71, 123, 0, 0, 0, 0, 0, 5, 114, 0, 0, 1, 0, 13, 2, 0, 34, 0, 0, 0, 0, 0, 0, 0, 0, 0, 0, 8, 29, 5, 0, 0, 0, 0, 0, 2, 189, 0, 28, 0, 0, 0, 0, 0, 0, 0, 54, 3, 119, 0, 0, 8, 1, 0, 0, 1, 0, 0, 93, 0, 7, 986, 73, 313, 0, 86, 0, 0, 0, 0, 0, 1, 0, 0, 1, 0, 172, 10, 0, 26, 4, 6, 3, 1, 0, 0, 0, 6, 9, 0, 22, 24, 0, 0, 0, 26, 0, 0, 0, 14, 1, 0, 0, 2, 3, 0, 203, 0, 0, 1, 0, 0, 2, 4, 0, 2, 8, 869, 28, 0, 0, 42, 0, 0, 0, 49, 0, 0, 0, 1, 29, 0, 0, 0, 0, 1, 0, 0, 74, 0, 1, 103, 0, 0, 0, 2, 3, 57, 0, 1, 4, 0, 0, 1387, 34, 0, 0, 36, 0, 0, 0, 0, 2, 0, 3, 0, 0, 6, 0, 0, 8, 7, 0, 2, 1, 3, 0, 3, 0, 44, 0, 0, 0, 0, 0, 0, 46, 61, 1, 0, 0, 114, 0, 1, 99, 20, 0, 0, 0, 0, 0, 0, 0, 0, 2, 1, 0, 0, 0, 0, 2, 5, 0, 0, 0, 0, 40, 0, 0, 19, 40, 54, 41, 1, 0, 33, 0, 0, 0, 45, 11, 12, 0, 0, 180, 0, 0, 0, 0, 0, 3, 0, 37, 0, 50, 17, 0, 0, 11, 0, 0, 0, 5, 1, 117, 0, 2, 0, 73, 0, 1, 0, 4, 203, 5, 0, 0, 0, 54, 0, 0, 0, 8, 73, 0, 0, 131, 0, 0, 103, 50, 5, 22, 0, 0, 1, 12, 0, 80, 0, 0, 0, 0, 2, 0, 0, 59, 1, 0, 0, 0, 9, 535, 0, 0, 92, 25, 1, 0, 0, 4, 0, 148, 0, 0, 0, 0, 147, 0, 0, 0, 0, 0, 4, 0, 1, 0, 0, 2, 1, 142, 0, 34, 0, 2, 0, 23, 11, 0, 0, 117, 0, 0, 1, 0, 4, 0, 11, 0, 0, 0, 0, 0, 540, 440, 40, 0, 0, 0, 0, 11, 1, 0, 0, 4, 3, 1, 20, 0, 0, 0, 6, 0, 0, 2, 0, 0, 30, 0, 3, 0, 5, 0, 0, 0, 5, 2, 0, 0, 0, 51, 2, 0, 0, 1, 0, 0, 1, 0, 0, 0, 13, 0, 0, 0, 3, 49, 0, 0, 0, 0, 0, 7, 2, 0, 0, 1, 0, 0, 0, 13, 73, 0, 0, 1, 0, 14, 0, 1, 0, 14, 109, 0, 0, 3, 0, 0, 1, 82, 128, 124, 0, 0, 0, 1, 0, 0, 5, 0, 0, 11, 90, 0, 0, 0, 0, 0, 0, 0, 16, 0, 3, 0, 0, 0, 4, 0, 0, 0, 0, 0, 34, 0, 0, 1, 5, 3, 36, 0, 0, 203, 48, 0, 0, 1, 0, 0, 1, 0, 6, 8, 0, 0, 0, 2, 0, 0, 0, 0, 90, 88, 0, 0, 0, 13, 0, 1, 81, 0, 4, 0, 0, 0, 0, 0, 1, 113, 0, 9, 18, 0, 0, 0, 1, 0, 5, 0, 11, 5, 0, 0, 6, 0, 0, 39, 0, 92, 0, 0, 0, 12, 1, 0, 0, 0, 16, 17, 0, 0, 112, 0, 0, 46, 0, 0, 0, 0, 66, 200, 0, 3, 1, 86, 1, 0, 6, 14, 0, 19, 0, 0, 0, 0, 20, 0, 29, 0, 0, 10, 0, 0, 0, 0, 27, 0, 0, 16, 74, 0, 0, 0, 4, 19, 0, 60, 0, 1, 0, 0, 62, 0, 0, 11, 1, 61, 95, 51, 0
Saudi_-Inc.-The-Arabian-Kingdom’s-Pursuit-of-Profit-and-Power-by-Ellen-R.-Wald-_z-lib.org_, 0, 0, 0, 11, 25, 0, 0, 0, 0, 61, 0, 17, 0, 0, 0, 0, 0, 0, 0, 0, 0, 0, 0, 6, 0, 0, 0, 0, 4, 1, 0, 0, 0, 0, 0, 0, 0, 2, 51, 0, 21, 0, 85, 66, 0, 0, 0, 1, 0, 0, 0, 22, 0, 0, 0, 0, 0, 0, 0, 0, 40, 0, 0, 0, 31, 0, 0, 103, 0, 3, 79, 0, 0, 0, 0, 0, 0, 0, 4, 0, 0, 0, 0, 0, 0, 26, 0, 6, 0, 35, 0, 0, 2, 0, 0, 0, 0, 12, 1, 8, 22, 0, 0, 0, 0, 0, 0, 0, 2, 0, 0, 20, 0, 1, 0, 30, 0, 5, 3, 0, 1, 7, 0, 0, 121, 105, 0, 0, 0, 0, 1, 0, 1, 0, 0, 0, 0, 0, 0, 58, 0, 0, 0, 0, 0, 29, 91, 0, 3, 0, 0, 0, 0, 0, 7, 12, 0, 0, 19, 0, 0, 22, 0, 0, 2, 0, 8, 1, 59, 149, 0, 2, 0, 33, 1, 0, 1, 0, 14, 3, 0, 68, 0, 54, 0, 0, 0, 2, 0, 0, 0, 0, 0, 1, 13, 0, 0, 0, 31, 0, 0, 1, 0, 40, 0, 0, 0, 0, 1, 4, 9, 29, 3, 0, 19, 0, 0, 0, 0, 8, 0, 0, 0, 0, 0, 0, 0, 0, 0, 0, 0, 0, 0, 0, 37, 0, 4, 0, 0, 0, 0, 11, 7, 0, 0, 0, 0, 0, 0, 0, 26, 0, 0, 29, 11, 0, 78, 0, 0, 0, 0, 1, 3, 1, 0, 0, 3, 0, 0, 25, 0, 0, 29, 1, 15, 12, 1, 80, 0, 0, 11, 0, 0, 0, 4, 0, 0, 0, 3, 7, 0, 30, 1, 1, 0, 0, 0, 19, 5, 17, 0, 19, 0, 0, 0, 181, 69, 0, 0, 0, 22, 0, 0, 0, 1, 6, 0, 2, 0, 0, 8, 0, 47, 5, 0, 0, 0, 0, 17, 0, 0, 49, 0, 11, 0, 0, 0, 0, 0, 0, 0, 0, 0, 0, 0, 0, 48, 0, 0, 54, 0, 24, 2, 0, 14, 1, 0, 41, 0, 0, 6, 0, 18, 0, 0, 0, 3, 0, 24, 0, 0, 0, 1, 1, 0, 0, 37, 18, 0, 14, 0, 0, 1, 0, 0, 8, 1, 4, 8, 0, 1, 6, 0, 0, 0, 0, 0, 8, 0, 0, 0, 0, 0, 0, 0, 0, 0, 0, 0, 15, 1, 14, 0, 0, 0, 0, 0, 0, 0, 0, 0, 0, 0, 0, 0, 32, 0, 0, 30, 0, 0, 49, 0, 0, 1346, 0, 0, 0, 39, 9, 0, 10, 0, 0, 43, 0, 0, 0, 0, 0, 0, 0, 1, 0, 6, 0, 40, 18, 0, 0, 0, 239, 0, 0, 13, 0, 13, 0, 0, 0, 0, 0, 0, 0, 0, 0, 0, 0, 0, 23, 0, 0, 4, 0, 0, 0, 48, 0, 1, 0, 0, 0, 0, 0, 0, 0, 0, 1, 12, 8, 0, 1, 0, 14, 0, 0, 0, 0, 0, 0, 0, 1, 0, 0, 63, 24, 0, 13, 1, 0, 0, 0, 34, 0, 0, 44, 0, 0, 0, 3, 4, 0, 356, 0, 0, 693, 0, 21, 0, 0, 4, 6, 0, 6, 0, 0, 1, 1, 37, 3, 0, 7, 31, 0, 0, 0, 8, 0, 0, 3, 2, 0, 35, 0, 0, 0, 0, 4, 0, 0, 17, 3, 0, 2, 0, 0, 13, 40, 0, 0, 4, 0, 0, 0, 0, 2, 0, 0, 0, 0, 0, 0, 12, 0, 0, 5, 0, 32, 0, 102, 0, 0, 0, 16, 0, 0, 0, 0, 1, 6, 16, 1, 7, 0, 18, 0, 0, 2, 2, 0, 0, 1, 0, 0, 19, 1, 0, 24, 0, 15, 0, 8, 0, 1, 0, 0, 170, 0, 0, 0, 0, 29, 0, 0, 5, 0, 50, 0, 0, 0, 0, 2, 6, 0, 0, 0, 0, 19, 0, 0, 0, 0, 32, 0, 6, 0, 1, 0, 7, 0, 0, 0, 0, 0, 12, 19, 0, 1, 0, 0, 0, 30, 0, 0, 8, 4, 0, 0, 12, 7, 0, 12, 0, 0, 1, 3, 0, 91, 0, 1, 8, 1, 0, 0, 0, 0, 19, 27, 0, 0, 0, 43, 0, 0, 39, 0, 12, 0, 0, 0, 0, 0, 0, 0, 0, 22, 0, 1, 0, 4, 0, 0, 10, 14, 0, 0, 0, 0, 0, 0, 0, 0, 0, 0, 0, 9, 0, 0, 0, 26, 0, 0, 7, 0, 0, 0, 0, 0, 0, 0, 4, 0, 0, 0, 0, 0, 0, 0, 9, 0, 0, 0, 0, 12, 0, 1, 14, 0, 0, 2, 22, 13, 0, 1, 0, 101, 6, 0, 17, 2, 0, 0, 0, 2, 0, 0, 54, 0, 0, 0, 0, 0, 0, 0, 0, 0, 0, 32, 0, 0, 0, 0, 0, 81, 0, 0, 0, 0, 4, 0, 52, 0, 9, 0, 9, 0, 0, 8, 2, 0, 103, 0, 30, 0, 0, 0, 3, 0, 0, 0, 2, 0, 1, 0, 0, 0, 1, 9, 20, 23, 26, 0, 46, 0, 0, 0, 26, 0, 0, 0, 0, 15, 0, 0, 0, 0, 3, 0, 0, 0, 0, 13, 2, 0, 0, 0, 12, 5, 0, 6, 7, 29, 11, 0, 0, 0, 3, 0, 0, 69, 1, 0, 0, 7, 0, 29, 0, 2, 0, 0, 0, 22, 13, 0, 0, 1, 0, 0, 0, 0, 0, 0, 0, 197, 0, 0, 0, 0, 0, 0, 0, 0, 0, 0, 0, 25, 0, 6, 0, 0, 0, 0, 34, 0, 47, 0, 0, 0, 3, 5, 0, 0, 14, 0, 0, 1, 0, 0, 0, 0, 1, 0, 0, 0, 3, 0, 81, 13, 3, 0, 8, 0, 0, 2, 0, 2, 0, 0, 0, 0, 0, 1, 0, 0, 70, 0, 0, 0, 27, 0, 0, 0, 60, 0, 0, 1, 22, 0, 0, 43, 0, 0, 2, 46, 0, 31, 0, 0, 0, 0, 0, 1, 0, 0, 0, 4, 1, 6, 30, 2, 0, 0, 93, 4, 0, 2, 0, 1, 1, 0, 2, 0, 0, 152, 0, 3, 28, 4, 0, 43, 5, 1, 0, 0, 5, 0, 0, 0, 0, 0, 58, 0, 0, 0, 1, 0, 0, 3, 0, 0, 1, 0, 29, 0, 0, 85, 10, 0, 0, 3, 0, 1, 0, 0, 3, 8, 0, 0, 1, 0, 0, 0, 22, 9, 0, 0, 72, 0, 20, 74, 0, 0, 1, 0, 0, 0, 0, 0, 15, 0, 0, 0, 0, 0, 49, 0, 8, 0, 0, 7, 77, 8, 0, 0, 31, 62, 5, 84, 0, 0, 0, 23, 0, 25, 83, 0, 0, 18, 29, 0, 0, 0, 0, 0, 3, 0, 27, 0, 1, 0, 0, 0, 3, 1, 4, 0, 77, 1, 0, 0, 0, 0, 0, 8, 3, 8, 0, 0, 0, 0, 0, 0, 1, 39, 0, 0, 1, 0, 6, 0, 2, 0, 0, 0, 0, 0, 0, 0, 0, 0, 0, 0, 11, 18, 0, 0, 0, 0, 0, 0, 4, 21, 0, 2, 0, 0, 0, 0, 0, 0, 0, 1, 0, 20, 0, 0, 12, 2, 0, 0, 3, 1, 0, 1, 0, 2, 4, 30, 0, 0, 0, 0, 0, 0, 0, 0, 0, 0, 0, 0, 0, 26, 0, 252, 49, 1, 11, 0, 0, 0, 0, 0, 0, 19, 0, 25, 1, 0, 0, 0, 7, 1, 0, 0, 37, 7, 0, 0, 7, 8, 0, 0, 0, 0, 4, 0, 0, 0, 0, 24, 3, 0, 8, 0, 0, 0, 0, 53, 2, 0, 30, 0, 0, 0, 21, 1, 0, 0, 0, 0, 1, 0, 0, 0, 0, 0, 775, 0, 0, 0, 0, 0, 0, 0, 0, 7, 0, 0, 443, 4, 0, 0, 5, 0, 0, 0, 0, 0, 0, 0, 0, 0, 28, 0, 0, 67, 1, 0, 2, 0, 1, 0, 0, 0, 59, 0, 0, 0, 0, 0, 0, 0, 29, 1, 0, 0, 18, 0, 15, 30, 14, 0, 0, 0, 0, 0, 0, 0, 40, 0, 0, 1, 0, 0, 0, 0, 0, 0, 0, 0, 0, 25, 0, 0, 0, 88, 92, 8, 0, 0, 9, 1, 0, 0, 31, 12, 0, 0, 114, 0, 0, 0, 0, 0, 0, 0, 0, 43, 0, 6, 22, 0, 0, 24, 0, 0, 0, 4, 1, 13, 0, 59, 0, 20, 0, 63, 0, 15, 50, 0, 0, 0, 0, 0, 0, 0, 0, 2, 23, 0, 0, 4, 0, 0, 26, 9, 0, 6, 0, 0, 0, 6, 0, 64, 0, 0, 0, 0, 0, 0, 0, 12, 1, 0, 0, 0, 2, 0, 0, 0, 32, 4, 1, 0, 0, 26, 1, 33, 0, 0, 857, 1, 2, 0, 0, 0, 0, 0, 2, 0, 0, 0, 0, 0, 0, 51, 0, 3, 0, 0, 1, 5, 480, 0, 0, 12, 0, 0, 28, 2, 8, 0, 6, 0, 0, 0, 0, 0, 85, 8, 6, 0, 0, 0, 0, 0, 1, 0, 0, 1, 8, 9, 15, 0, 0, 0, 9, 0, 0, 0, 0, 0, 11, 4, 1, 0, 19, 0, 0, 0, 0, 0, 0, 0, 0, 18, 0, 0, 0, 0, 0, 0, 0, 0, 0, 0, 3, 0, 0, 0, 1, 0, 0, 46, 0, 0, 0, 0, 0, 0, 0, 0, 0, 0, 0, 7, 0, 0, 0, 0, 0, 6, 0, 9, 0, 61, 13, 0, 0, 20, 0, 0, 0, 22, 17, 31, 0, 0, 127, 76, 0, 0, 4, 0, 0, 33, 1, 0, 0, 0, 0, 0, 0, 0, 14, 0, 0, 0, 0, 0, 12, 2, 0, 0, 2, 0, 4, 0, 0, 5, 0, 0, 58, 0, 0, 24, 69, 0, 0, 0, 212, 0, 3, 13, 17, 0, 0, 0, 0, 2, 0, 0, 0, 0, 7, 21, 0, 0, 0, 29, 0, 0, 33, 30, 6, 0, 0, 0, 0, 0, 0, 41, 7, 25, 19, 1, 0, 0, 0, 1, 16, 159, 0, 1, 0, 0, 0, 0, 0, 88, 0, 21, 0, 0, 0, 10, 0, 0, 0, 0, 7, 124, 0, 0, 25, 0, 0, 15, 0, 0, 0, 0, 44, 52, 0, 0, 66, 28, 6, 0, 0, 6, 0, 0, 0, 0, 0, 0, 17, 0, 0, 0, 0, 0, 0, 0, 0, 0, 19, 0, 0, 6, 359, 0, 0, 2, 0, 15, 0, 15, 0, 3, 0, 0, 0, 0, 0, 9, 0, 27, 26, 20, 21
Secret-Formula-The-Inside-Story-of-How-Coca-Cola-Became-the-Best-Known-Brand-in-the-World-by-Frederi, 0, 0, 0, 49, 43, 0, 0, 0, 0, 35, 0, 50, 2, 0, 0, 0, 1, 0, 0, 0, 0, 0, 0, 5, 0, 0, 0, 95, 24, 0, 0, 0, 0, 0, 0, 0, 0, 2, 55, 0, 24, 0, 163, 1, 1, 0, 0, 3, 0, 0, 0, 125, 0, 0, 0, 10, 0, 0, 0, 1, 136, 0, 0, 0, 24, 0, 0, 94, 0, 6, 1, 0, 0, 3, 6, 2, 0, 0, 119, 0, 0, 0, 0, 0, 0, 64, 0, 7, 0, 233, 0, 0, 18, 1, 0, 0, 0, 0, 3, 7, 5, 217, 0, 0, 0, 0, 0, 0, 12, 1, 0, 43, 0, 0, 0, 55, 0, 16, 0, 0, 2, 0, 1, 0, 31, 317, 0, 0, 0, 0, 13, 0, 0, 0, 0, 0, 1, 0, 0, 33, 0, 1, 0, 0, 1, 11, 97, 0, 13, 0, 0, 0, 3, 0, 16, 13, 7, 0, 50, 3, 1, 63, 0, 0, 2, 0, 31, 5, 37, 20, 0, 131, 0, 21, 1, 0, 14, 0, 27, 58, 0, 69, 0, 71, 0, 0, 0, 30, 0, 34, 0, 0, 8, 19, 18, 3, 0, 1, 22, 1, 0, 14, 0, 68, 0, 1, 12, 0, 5, 19, 19, 37, 21, 0, 12, 0, 1, 73, 0, 11, 0, 0, 0, 0, 41, 0, 0, 0, 4, 48, 0, 69, 64, 0, 0, 0, 10, 0, 0, 0, 0, 37, 7, 0, 0, 0, 0, 1, 0, 217, 59, 0, 0, 0, 203, 0, 62, 1, 0, 0, 0, 9, 26, 5, 0, 0, 2, 1, 0, 30, 4, 0, 54, 7, 11, 32, 1, 0, 0, 0, 187, 0, 0, 0, 13, 0, 0, 0, 1, 15, 1, 22, 3, 2, 0, 13, 0, 55, 2, 21, 1, 3, 1, 0, 0, 111, 38, 0, 0, 0, 28, 0, 0, 0, 0, 17, 0, 9, 0, 2, 8, 0, 0, 11, 0, 0, 0, 0, 50, 0, 0, 21, 0, 65, 5, 0, 0, 2, 0, 0, 14, 0, 0, 0, 0, 0, 77, 1, 0, 6, 0, 10, 8, 0, 45, 26, 0, 177, 0, 0, 10, 0, 20, 50, 0, 0, 14, 0, 33, 2, 0, 0, 0, 2, 0, 0, 7, 29, 0, 215, 0, 0, 45, 0, 0, 6, 6, 0, 16, 0, 25, 14, 0, 0, 0, 0, 0, 1, 1, 0, 0, 0, 0, 2, 0, 0, 0, 0, 0, 189, 6, 0, 0, 0, 10, 0, 0, 0, 0, 0, 0, 0, 4, 0, 0, 11, 0, 0, 113, 0, 0, 6, 0, 2, 0, 0, 0, 2, 64, 5, 0, 22, 0, 0, 124, 1, 2, 0, 1, 0, 0, 0, 26, 0, 8, 0, 36, 9, 1, 0, 6, 399, 0, 7, 13, 0, 41, 0, 0, 0, 0, 0, 0, 0, 60, 0, 0, 0, 1, 48, 0, 0, 8, 0, 1, 0, 65, 0, 2, 0, 0, 0, 0, 0, 0, 0, 4, 4, 35, 3, 0, 0, 0, 35, 0, 0, 0, 0, 0, 0, 0, 1, 2, 0, 53, 70, 0, 8, 0, 0, 0, 0, 27, 0, 0, 78, 0, 11, 0, 6, 11, 0, 0, 2, 0, 0, 2, 34, 0, 0, 48, 38, 1, 9, 2, 0, 3, 0, 0, 2, 0, 1, 9, 0, 2, 0, 36, 0, 0, 10, 0, 0, 0, 63, 0, 0, 0, 43, 0, 0, 51, 0, 0, 205, 0, 0, 4, 47, 316, 2, 12, 0, 0, 1, 16, 11, 0, 0, 2, 0, 0, 0, 97, 0, 0, 10, 0, 58, 0, 117, 0, 0, 0, 63, 0, 0, 0, 0, 6, 13, 47, 1901, 168, 0, 42, 0, 0, 6, 16, 0, 0, 0, 0, 0, 96, 0, 0, 19, 9, 24, 0, 30, 252, 21, 0, 0, 147, 0, 0, 0, 0, 25, 0, 0, 22, 0, 97, 3, 0, 0, 0, 0, 89, 0, 1, 2, 4, 31, 0, 0, 0, 0, 22, 0, 2, 0, 9, 0, 10, 0, 1, 0, 1, 0, 1, 24, 0, 0, 0, 0, 0, 98, 2, 0, 48, 7, 0, 0, 33, 3, 0, 37, 0, 0, 5, 4, 0, 0, 0, 1, 49, 1, 0, 0, 0, 0, 36, 21, 0, 0, 0, 193, 0, 0, 115, 0, 9, 0, 0, 0, 0, 9, 0, 0, 0, 53, 0, 9, 0, 8, 0, 0, 18, 96, 0, 0, 0, 0, 0, 0, 0, 0, 8, 0, 0, 15, 17, 0, 248, 13, 0, 22, 43, 0, 0, 0, 3, 2, 0, 0, 203, 1, 78, 0, 3, 0, 1, 0, 25, 0, 1, 0, 0, 46, 0, 17, 42, 0, 0, 20, 11, 25, 0, 23, 1, 109, 13, 0, 29, 51, 0, 0, 0, 19, 0, 25, 30, 0, 0, 0, 0, 0, 0, 0, 0, 0, 0, 30, 72, 1, 0, 10, 0, 15, 4, 0, 0, 0, 16, 0, 0, 0, 58, 0, 26, 0, 0, 1, 4, 1, 64, 0, 35, 9, 0, 1, 13, 0, 0, 0, 1, 0, 3, 0, 13, 1, 0, 15, 9, 23, 46, 3, 4, 0, 0, 0, 22, 3, 0, 0, 0, 13, 0, 0, 0, 0, 3, 0, 1, 0, 0, 17, 7, 360, 0, 0, 34, 10, 8, 8, 4, 25, 12, 0, 0, 0, 3, 0, 2, 209, 14, 0, 34, 4, 0, 35, 0, 46, 2, 0, 3, 18, 26, 1, 0, 5, 0, 1, 0, 0, 0, 0, 0, 102, 0, 0, 0, 0, 27, 0, 0, 0, 0, 0, 0, 14, 0, 2, 0, 1, 0, 0, 21, 1, 53, 0, 1, 133, 1, 0, 0, 3, 7, 0, 0, 2, 0, 0, 0, 0, 13, 0, 0, 0, 0, 0, 0, 40, 5, 0, 31, 0, 0, 20, 0, 47, 46, 4, 11, 0, 0, 6, 0, 0, 43, 0, 0, 0, 26, 0, 0, 0, 13, 0, 0, 2, 70, 0, 0, 129, 0, 0, 13, 194, 0, 8, 8, 0, 0, 0, 1, 0, 0, 0, 0, 2, 0, 140, 16, 1, 0, 0, 0, 13, 3, 12, 0, 142, 0, 0, 14, 0, 0, 143, 0, 0, 0, 0, 448, 71, 69, 0, 0, 0, 18, 2, 0, 0, 2, 0, 48, 0, 0, 0, 1, 0, 0, 0, 0, 0, 3, 0, 22, 0, 0, 23, 1, 0, 0, 12, 0, 0, 0, 2, 1, 35, 10, 0, 1, 0, 0, 0, 48, 19, 0, 3, 11, 0, 34, 1, 0, 0, 7, 0, 0, 0, 0, 1, 61, 0, 0, 0, 0, 0, 61, 0, 4, 0, 4, 4, 127, 43, 0, 4, 115, 25, 0, 0, 0, 4, 0, 39, 0, 193, 0, 0, 0, 21, 98, 0, 0, 0, 0, 0, 7, 3, 89, 0, 0, 5, 0, 3, 16, 4, 26, 0, 107, 5, 0, 0, 0, 3, 0, 51, 43, 9, 0, 0, 0, 0, 0, 0, 3, 26, 0, 88, 1, 0, 16, 0, 0, 2, 0, 0, 0, 3, 0, 0, 0, 3, 0, 0, 22, 7, 0, 0, 0, 0, 0, 0, 6, 47, 0, 6, 0, 0, 3, 0, 1, 0, 0, 4, 2, 8, 0, 0, 8, 13, 0, 0, 6, 0, 57, 18, 0, 20, 29, 110, 4, 0, 1, 0, 0, 0, 0, 2, 4, 0, 0, 0, 0, 53, 14, 0, 68, 10, 12, 15, 3, 0, 0, 0, 31, 31, 0, 56, 254, 0, 0, 0, 23, 4, 0, 0, 55, 3, 0, 0, 4, 1, 0, 0, 0, 0, 19, 0, 0, 0, 0, 31, 1, 53, 170, 0, 0, 0, 0, 0, 0, 0, 94, 0, 0, 0, 25, 10, 0, 0, 0, 0, 4, 12, 0, 0, 0, 0, 24, 0, 0, 0, 166, 2, 0, 0, 4, 5, 0, 0, 1652, 1, 0, 0, 30, 0, 1, 0, 3, 4, 0, 3, 0, 1, 66, 1, 0, 132, 1, 0, 1, 0, 0, 0, 42, 0, 175, 0, 0, 0, 0, 0, 0, 0, 104, 1, 0, 0, 57, 5, 52, 96, 32, 0, 0, 0, 0, 0, 0, 1, 0, 41, 0, 0, 0, 0, 0, 0, 64, 0, 0, 0, 0, 9, 0, 0, 7, 104, 49, 64, 0, 2, 41, 39, 0, 0, 41, 3, 0, 0, 0, 4, 0, 0, 0, 0, 0, 12, 0, 39, 0, 8, 9, 0, 0, 29, 0, 0, 0, 289, 0, 41, 0, 157, 0, 41, 0, 9, 0, 61, 105, 25, 1, 0, 0, 0, 0, 1, 0, 47, 26, 0, 1, 21, 3, 0, 29, 22, 3, 32, 0, 0, 2, 22, 2, 95, 0, 1, 0, 9, 1, 7, 0, 5, 5, 0, 0, 0, 6, 2, 0, 0, 33, 4, 7, 0, 0, 96, 0, 36, 0, 0, 0, 1, 5, 0, 0, 0, 0, 8, 3, 0, 20, 0, 123, 2, 0, 3, 0, 27, 0, 1, 4, 12, 35, 0, 0, 10, 0, 0, 0, 3, 37, 1, 19, 0, 0, 0, 15, 0, 327, 74, 3, 0, 0, 0, 0, 0, 9, 0, 0, 1, 2, 1, 3, 8, 2, 0, 45, 0, 0, 0, 0, 0, 6, 0, 0, 0, 12, 0, 0, 0, 2, 0, 0, 1, 0, 27, 13, 0, 0, 1, 0, 0, 0, 0, 0, 0, 51, 0, 0, 2, 17, 27, 0, 1, 0, 3, 0, 0, 1, 0, 0, 0, 0, 0, 0, 110, 1, 0, 0, 0, 0, 8, 1, 4, 0, 42, 44, 0, 0, 126, 0, 0, 0, 64, 17, 60, 0, 0, 5, 14, 0, 1, 31, 0, 0, 11, 49, 0, 0, 0, 0, 0, 0, 0, 39, 0, 0, 0, 108, 0, 15, 2, 4, 0, 5, 0, 24, 20, 0, 18, 14, 4, 144, 0, 1, 48, 96, 0, 0, 0, 0, 0, 1, 9, 29, 127, 0, 0, 2, 8, 0, 0, 1, 107, 28, 51, 0, 0, 2, 50, 0, 0, 119, 1, 17, 0, 0, 0, 0, 0, 1, 58, 3, 71, 36, 0, 0, 0, 0, 0, 6, 0, 25, 1804, 0, 0, 1, 0, 99, 106, 0, 52, 0, 0, 0, 17, 58, 0, 0, 0, 0, 83, 0, 87, 20, 2, 0, 18, 0, 2, 6, 0, 29, 126, 0, 30, 1, 29, 2, 0, 5, 5, 0, 3, 0, 0, 7, 0, 47, 0, 20, 0, 0, 0, 0, 0, 0, 0, 20, 0, 0, 6, 175, 0, 0, 0, 0, 100, 0, 35, 0, 1, 0, 0, 1, 0, 0, 0, 2, 42, 77, 52, 12
Software and Organisations The Biography of the Enterprise-Wide System or How SAP Conquered the World by Neil Pollock- Robin Williams (z-lib.org), 0, 0, 0, 94, 12, 0, 0, 7, 0, 58, 0, 0, 0, 0, 0, 0, 38, 0, 0, 0, 0, 0, 0, 81, 0, 0, 0, 0, 2, 3, 0, 0, 6, 0, 0, 0, 0, 1, 138, 0, 9, 0, 0, 0, 0, 0, 0, 9, 0, 0, 0, 20, 0, 0, 0, 0, 0, 0, 0, 0, 43, 0, 0, 0, 0, 0, 0, 1, 0, 0, 0, 0, 0, 0, 0, 0, 80, 0, 14, 0, 0, 0, 0, 0, 0, 0, 0, 0, 0, 21, 0, 0, 27, 0, 0, 0, 1, 0, 0, 0, 0, 0, 0, 0, 0, 0, 0, 0, 2, 0, 0, 13, 0, 0, 0, 11, 0, 0, 0, 0, 0, 0, 0, 0, 53, 35, 6, 0, 0, 0, 3, 0, 0, 0, 0, 0, 0, 0, 0, 0, 0, 0, 0, 0, 0, 2, 20, 0, 0, 0, 0, 0, 0, 0, 138, 17, 1, 0, 19, 0, 0, 9, 0, 0, 0, 0, 8, 146, 1, 0, 0, 0, 0, 25, 0, 21, 0, 0, 27, 0, 0, 13, 0, 17, 0, 0, 0, 11, 0, 5, 0, 0, 1, 3, 5, 0, 0, 4, 29, 0, 0, 3, 0, 38, 0, 0, 2, 0, 12, 34, 41, 15, 0, 45, 98, 0, 0, 0, 0, 1, 0, 0, 0, 0, 2, 0, 0, 0, 0, 1, 0, 0, 0, 310, 0, 0, 82, 0, 5, 0, 0, 7, 0, 0, 0, 0, 0, 2, 0, 0, 52, 29, 0, 0, 10, 0, 30, 1, 0, 0, 0, 3, 2, 0, 0, 0, 0, 0, 0, 0, 3, 242, 16, 0, 1, 0, 0, 0, 0, 0, 0, 45, 0, 0, 0, 0, 0, 0, 0, 2, 0, 68, 0, 0, 0, 0, 0, 33, 0, 157, 1, 617, 0, 0, 0, 23, 244, 0, 0, 0, 83, 0, 0, 0, 15, 16, 0, 438, 0, 0, 113, 0, 0, 78, 0, 0, 0, 0, 30, 0, 0, 1, 0, 1, 0, 0, 0, 0, 0, 0, 0, 0, 0, 0, 0, 0, 129, 0, 21, 6, 0, 0, 0, 0, 77, 0, 0, 11, 0, 0, 111, 0, 0, 0, 0, 0, 23, 0, 12, 0, 0, 0, 12, 1, 34, 0, 70, 0, 1, 21, 0, 0, 8, 0, 0, 3, 0, 0, 3, 0, 0, 244, 0, 0, 0, 0, 0, 0, 0, 0, 0, 0, 0, 0, 1, 0, 0, 2, 0, 0, 99, 0, 0, 0, 17, 0, 0, 0, 0, 0, 0, 0, 0, 0, 0, 7, 0, 0, 55, 0, 0, 1, 0, 0, 0, 0, 0, 0, 17, 0, 0, 45, 0, 0, 25, 0, 0, 0, 0, 0, 0, 0, 0, 0, 5, 0, 58, 17, 0, 0, 0, 146, 0, 0, 0, 0, 3, 0, 0, 0, 0, 0, 0, 21, 0, 0, 0, 0, 0, 0, 0, 0, 4, 0, 0, 0, 2, 0, 0, 0, 0, 0, 0, 0, 0, 0, 0, 0, 0, 22, 0, 0, 0, 4, 0, 0, 0, 0, 0, 0, 0, 0, 0, 0, 50, 29, 0, 0, 0, 0, 0, 0, 19, 0, 0, 51, 0, 1, 0, 0, 37, 0, 0, 0, 0, 0, 2, 239, 0, 0, 2, 0, 0, 0, 0, 0, 0, 0, 0, 0, 0, 220, 1, 0, 0, 0, 10, 0, 0, 155, 6, 0, 0, 0, 0, 0, 0, 0, 0, 0, 8, 0, 0, 1, 0, 0, 2, 73, 0, 0, 1, 0, 0, 0, 34, 0, 0, 0, 3, 0, 1, 1, 1, 0, 0, 6, 32, 117, 0, 0, 0, 0, 1, 137, 0, 0, 0, 0, 0, 1, 9, 0, 0, 0, 4, 0, 0, 125, 2, 0, 0, 80, 0, 0, 17, 0, 0, 43, 6, 2, 0, 60, 0, 1, 0, 0, 18, 0, 0, 1, 0, 60, 0, 0, 1, 0, 35, 147, 0, 0, 0, 0, 0, 0, 0, 0, 0, 68, 0, 0, 0, 0, 381, 0, 0, 0, 0, 0, 2, 0, 0, 0, 0, 0, 84, 72, 0, 0, 0, 0, 5, 6, 0, 0, 3, 120, 0, 0, 3, 1, 0, 167, 0, 0, 0, 142, 0, 0, 0, 0, 216, 0, 0, 0, 0, 0, 150, 297, 0, 57, 0, 3, 0, 0, 8, 0, 5, 0, 0, 0, 0, 0, 0, 18, 0, 120, 0, 0, 25, 2, 0, 0, 49, 1, 0, 0, 0, 0, 45, 0, 0, 0, 0, 0, 0, 18, 0, 0, 2, 16, 0, 0, 20, 0, 0, 77, 0, 0, 0, 0, 1, 0, 0, 0, 0, 0, 0, 0, 31, 0, 1, 0, 0, 7, 0, 1, 8, 0, 0, 0, 12, 0, 0, 0, 9, 34, 2, 0, 122, 136, 0, 0, 0, 1, 0, 0, 97, 0, 0, 0, 0, 0, 0, 0, 0, 0, 0, 45, 0, 0, 0, 0, 32, 0, 0, 0, 0, 0, 21, 0, 0, 0, 0, 0, 1, 0, 0, 148, 117, 0, 4, 0, 10, 0, 0, 0, 0, 0, 0, 0, 0, 0, 0, 0, 0, 0, 1, 19, 109, 50, 0, 0, 0, 0, 0, 0, 118, 0, 0, 0, 0, 3, 0, 0, 0, 0, 8, 0, 0, 0, 0, 23, 0, 0, 0, 0, 0, 0, 1, 0, 1, 184, 0, 0, 0, 0, 0, 0, 0, 68, 7, 0, 0, 0, 0, 31, 0, 22, 0, 0, 0, 10, 32, 0, 0, 16, 0, 0, 0, 0, 0, 0, 0, 11, 0, 0, 42, 35, 0, 32, 0, 0, 0, 0, 0, 1, 0, 0, 0, 0, 0, 0, 0, 0, 8, 0, 0, 0, 0, 13, 0, 0, 21, 0, 0, 0, 0, 0, 0, 0, 0, 0, 0, 93, 14, 0, 0, 1, 0, 0, 149, 3, 0, 0, 0, 12, 0, 0, 0, 0, 0, 3, 0, 0, 0, 0, 0, 0, 1, 0, 0, 0, 14, 0, 0, 4, 40, 0, 0, 46, 0, 0, 0, 34, 0, 259, 0, 0, 0, 0, 0, 0, 0, 0, 0, 0, 96, 14, 70, 54, 0, 0, 0, 225, 60, 0, 0, 0, 24, 0, 5, 0, 0, 1, 0, 0, 0, 0, 0, 34, 1, 0, 0, 2, 0, 0, 0, 0, 3, 77, 133, 0, 0, 0, 1, 0, 0, 0, 4, 0, 0, 0, 109, 0, 41, 3, 0, 0, 0, 7, 23, 0, 0, 25, 2, 16, 1, 0, 0, 52, 0, 0, 21, 1, 0, 0, 36, 0, 9, 0, 0, 0, 0, 0, 0, 0, 0, 0, 9, 0, 0, 0, 0, 0, 31, 0, 6, 0, 0, 3, 218, 14, 0, 0, 22, 136, 3, 0, 0, 0, 0, 24, 0, 20, 0, 0, 0, 15, 13, 0, 0, 0, 0, 0, 0, 1, 81, 0, 0, 0, 0, 1, 88, 0, 16, 0, 13, 617, 0, 0, 0, 1, 0, 6, 0, 4, 0, 0, 0, 0, 0, 0, 2, 128, 0, 0, 8, 0, 0, 0, 0, 0, 0, 0, 0, 0, 0, 0, 0, 0, 0, 0, 11, 210, 3, 0, 0, 0, 0, 0, 0, 139, 0, 352, 0, 0, 0, 0, 0, 0, 0, 0, 88, 94, 410, 0, 139, 0, 0, 0, 4, 0, 0, 34, 0, 13, 0, 24, 0, 0, 0, 0, 0, 0, 0, 0, 0, 0, 0, 0, 0, 68, 2, 0, 15, 0, 1, 1, 0, 0, 0, 0, 0, 1, 0, 4, 0, 0, 0, 0, 72, 1, 0, 0, 12, 1, 0, 0, 0, 2, 0, 0, 0, 0, 0, 0, 0, 0, 0, 0, 1, 0, 187, 0, 0, 2, 0, 0, 1, 0, 15, 198, 0, 0, 0, 5, 0, 0, 0, 0, 0, 0, 0, 0, 0, 3, 1, 0, 0, 0, 0, 155, 0, 0, 0, 0, 0, 2, 41, 27, 0, 0, 1, 0, 1, 0, 0, 0, 0, 2, 0, 0, 1, 0, 0, 9, 1, 0, 1, 0, 0, 0, 0, 0, 6, 0, 0, 0, 0, 0, 0, 0, 35, 1, 0, 0, 64, 8, 0, 19, 25, 0, 0, 0, 0, 0, 0, 0, 0, 0, 0, 0, 0, 0, 0, 114, 0, 0, 0, 0, 0, 21, 29, 0, 44, 54, 0, 0, 1, 3, 128, 3, 0, 0, 13, 12, 0, 0, 0, 25, 0, 0, 0, 0, 0, 0, 0, 19, 0, 24, 52, 0, 0, 0, 0, 0, 0, 0, 0, 5, 0, 0, 0, 5, 0, 0, 0, 7, 122, 0, 0, 0, 0, 0, 59, 0, 0, 1, 18, 0, 0, 13, 5, 0, 89, 7, 96, 2, 0, 0, 3, 7, 0, 15, 0, 76, 0, 0, 0, 0, 0, 34, 0, 0, 0, 0, 1, 2, 0, 0, 97, 53, 1, 0, 0, 1, 0, 33, 0, 0, 0, 0, 0, 0, 0, 0, 0, 0, 437, 43, 2, 0, 0, 0, 0, 54, 0, 108, 0, 1, 114, 11, 0, 0, 0, 0, 0, 0, 0, 2, 0, 0, 0, 0, 0, 0, 0, 0, 99, 13, 0, 0, 0, 0, 0, 0, 1, 0, 0, 0, 8, 0, 33, 0, 1, 0, 0, 0, 0, 0, 0, 0, 9, 0, 6, 26, 11, 0, 0, 0, 0, 10, 0, 0, 0, 82, 0, 0, 0, 1, 0, 0, 0, 0, 0, 0, 2, 0, 0, 1, 0, 1, 0, 0, 0, 0, 0, 0, 0, 0, 0, 0, 0, 0, 0, 3, 0, 0, 0, 0, 0, 0, 0, 1, 0, 38, 1, 4, 0, 0, 0, 0, 0, 36, 4, 37, 0, 0, 0, 0, 0, 0, 7, 0, 0, 2, 0, 0, 0, 26, 0, 0, 0, 0, 1, 0, 424, 0, 0, 0, 14, 0, 10, 0, 0, 0, 0, 4, 0, 4, 0, 3, 10, 0, 0, 69, 26, 0, 0, 0, 0, 0, 1, 0, 2, 0, 35, 25, 0, 0, 0, 0, 0, 0, 19, 141, 0, 0, 0, 27, 0, 35, 168, 0, 7, 0, 0, 0, 0, 0, 0, 193, 0, 2, 7, 92, 0, 0, 0, 0, 3, 0, 29, 0, 0, 0, 0, 0, 0, 31, 0, 88, 0, 0, 0, 51, 0, 0, 0, 100, 82, 1, 0, 0, 54, 0, 135, 10, 0, 0, 0, 0, 104, 172, 1, 0, 0, 1, 1, 0, 1, 73, 0, 4, 0, 0, 1, 0, 30, 0, 1, 0, 0, 132, 0, 0, 0, 0, 11, 0, 0, 6, 7, 0, 0, 0, 0, 17, 0, 24, 0, 0, 0, 0, 0, 0, 0, 17, 0, 3, 8, 4, 0
Steve-Jobs-the-man-who-thought-different-a-biography-_Apple-Computer_-IncJobs_-SteveBlumenthal-etc, 0, 0, 0, 14, 33, 0, 0, 0, 0, 21, 2, 2, 1, 0, 0, 0, 0, 0, 0, 0, 0, 0, 0, 2, 0, 0, 0, 0, 0, 0, 0, 0, 0, 0, 0, 0, 0, 0, 14, 0, 2, 0, 13, 0, 0, 0, 0, 0, 1, 0, 0, 13, 0, 0, 0, 0, 0, 0, 0, 0, 29, 0, 0, 0, 3, 0, 0, 1, 0, 0, 0, 0, 0, 0, 1, 0, 0, 0, 5, 0, 0, 0, 0, 0, 0, 9, 0, 0, 0, 112, 2, 0, 15, 1, 0, 0, 10, 0, 1, 0, 0, 0, 0, 0, 0, 0, 1, 0, 2, 0, 0, 7, 0, 0, 0, 4, 0, 2, 0, 0, 0, 0, 0, 0, 3, 73, 0, 12, 0, 0, 4, 0, 21, 0, 0, 0, 0, 0, 0, 2, 0, 17, 0, 0, 0, 0, 16, 0, 0, 0, 0, 0, 2, 0, 5, 5, 0, 0, 37, 0, 0, 23, 0, 0, 0, 0, 3, 1, 2, 0, 0, 0, 0, 4, 0, 0, 0, 0, 6, 2, 0, 6, 0, 10, 0, 0, 0, 6, 0, 5, 0, 0, 2, 1, 9, 0, 2, 22, 6, 0, 0, 2, 0, 14, 0, 0, 0, 0, 3, 6, 6, 1, 28, 0, 1, 0, 0, 0, 0, 3, 0, 0, 0, 0, 1, 0, 0, 0, 4, 0, 0, 0, 0, 0, 0, 0, 15, 0, 7, 0, 0, 3, 3, 0, 0, 0, 0, 0, 15, 0, 33, 0, 0, 0, 60, 0, 5, 0, 0, 0, 0, 1, 2, 25, 3, 0, 2, 0, 0, 9, 0, 0, 13, 2, 6, 20, 4, 0, 0, 0, 14, 0, 0, 0, 14, 0, 0, 0, 0, 17, 0, 3, 14, 0, 0, 0, 0, 12, 0, 1, 0, 37, 0, 0, 0, 3, 11, 0, 0, 12, 8, 0, 60, 0, 0, 13, 0, 9, 0, 0, 2, 0, 0, 2, 0, 0, 0, 0, 23, 0, 0, 6, 0, 4, 2, 0, 0, 0, 0, 0, 1, 0, 0, 0, 0, 0, 20, 0, 0, 0, 0, 3, 0, 0, 15, 0, 0, 37, 0, 0, 5, 0, 0, 0, 0, 0, 17, 0, 3, 2, 0, 0, 9, 33, 0, 0, 0, 19, 0, 54, 0, 0, 7, 0, 0, 0, 0, 0, 3, 0, 1, 5, 0, 0, 0, 0, 0, 0, 0, 0, 0, 0, 0, 35, 0, 0, 0, 0, 0, 14, 10, 0, 0, 0, 0, 0, 0, 0, 5, 0, 14, 0, 23, 19, 0, 4, 1, 0, 39, 0, 0, 112, 0, 0, 0, 0, 11, 0, 64, 0, 0, 15, 0, 1, 74, 0, 0, 0, 0, 0, 0, 1, 1, 0, 9, 16, 16, 3, 1, 0, 0, 159, 0, 6, 0, 0, 13, 0, 0, 0, 0, 0, 0, 0, 0, 0, 0, 0, 0, 18, 0, 0, 0, 0, 0, 0, 3, 0, 15, 0, 0, 0, 0, 0, 0, 0, 14, 0, 10, 0, 0, 1, 0, 10, 0, 0, 0, 0, 0, 0, 0, 0, 0, 0, 2, 29, 0, 8, 0, 0, 0, 0, 2, 0, 0, 6, 0, 0, 0, 0, 2, 0, 0, 0, 0, 0, 1, 5, 0, 0, 4, 1, 0, 1, 0, 0, 4, 0, 0, 6, 0, 0, 2, 0, 0, 0, 6, 0, 0, 0, 13, 0, 0, 0, 0, 0, 0, 11, 0, 0, 46, 0, 0, 2, 0, 0, 0, 17, 4, 0, 1, 19, 0, 0, 7, 7, 0, 0, 0, 0, 0, 0, 9, 0, 0, 4, 0, 3, 0, 24, 0, 0, 0, 8, 0, 0, 0, 0, 0, 1, 11, 1, 12, 0, 0, 20, 0, 2, 0, 0, 0, 0, 0, 0, 22, 0, 0, 15, 0, 4, 0, 6, 0, 4, 0, 0, 41, 0, 0, 14, 0, 8, 0, 0, 0, 0, 30, 0, 0, 0, 0, 0, 3, 0, 1, 0, 0, 3, 0, 0, 0, 0, 6, 51, 0, 0, 2, 0, 0, 0, 0, 0, 0, 0, 0, 14, 1, 0, 0, 0, 0, 856, 0, 0, 10, 2, 0, 0, 2, 0, 0, 65, 0, 0, 4, 0, 0, 0, 0, 0, 29, 0, 0, 0, 0, 0, 49, 17, 0, 0, 0, 15, 0, 2, 5, 0, 1, 0, 0, 0, 0, 2, 0, 0, 0, 6, 0, 19, 0, 3, 0, 0, 5, 3, 0, 0, 0, 0, 5, 0, 0, 0, 0, 0, 0, 1, 0, 0, 0, 37, 0, 1, 3, 0, 0, 0, 0, 0, 0, 0, 4, 0, 0, 0, 3, 0, 0, 0, 2, 0, 0, 0, 0, 8, 2, 0, 6, 0, 0, 2, 23, 0, 0, 2, 1, 15, 1, 0, 4, 4, 0, 0, 0, 15, 0, 0, 13, 0, 0, 0, 0, 0, 0, 0, 0, 0, 0, 18, 0, 0, 0, 55, 0, 0, 0, 0, 0, 0, 10, 0, 0, 0, 5, 0, 0, 0, 0, 3, 9, 0, 22, 0, 0, 2, 0, 0, 0, 0, 0, 0, 0, 0, 0, 0, 0, 0, 459, 2, 22, 5, 11, 0, 0, 0, 0, 0, 11, 0, 0, 0, 0, 0, 0, 0, 0, 1, 0, 0, 0, 0, 3, 9, 0, 1, 0, 0, 10, 10, 0, 0, 0, 2, 5, 0, 0, 0, 40, 4, 0, 93, 2, 0, 4, 0, 0, 15, 0, 12, 0, 0, 0, 7, 11, 0, 0, 3, 0, 0, 4, 0, 0, 0, 0, 0, 0, 0, 0, 0, 0, 0, 0, 0, 0, 0, 0, 3, 0, 0, 0, 0, 0, 0, 2, 0, 6, 0, 0, 2, 0, 3, 0, 0, 3, 2, 0, 1, 0, 0, 0, 0, 1, 0, 0, 0, 1, 0, 0, 9, 0, 0, 6, 0, 0, 0, 0, 40, 0, 4, 0, 0, 0, 8, 0, 0, 0, 0, 0, 0, 0, 0, 0, 0, 3, 0, 2, 0, 50, 0, 0, 26, 0, 0, 0, 69, 0, 5, 1, 0, 0, 0, 0, 0, 0, 0, 0, 0, 2, 15, 4, 0, 0, 24, 0, 3, 13, 0, 0, 6, 1, 1, 0, 0, 0, 50, 0, 0, 0, 0, 0, 28, 0, 1, 0, 3, 0, 0, 0, 0, 3, 0, 9, 0, 0, 0, 0, 0, 0, 2, 0, 0, 2, 0, 11, 13, 0, 1, 0, 0, 0, 5, 0, 1, 0, 0, 0, 9, 0, 0, 0, 0, 0, 0, 25, 0, 0, 0, 5, 0, 21, 0, 0, 0, 0, 0, 0, 0, 0, 0, 7, 0, 0, 0, 0, 0, 12, 13, 11, 0, 0, 1, 18, 12, 0, 1, 10, 14, 1, 0, 0, 0, 0, 12, 0, 22, 1, 0, 0, 4, 3, 9, 0, 0, 0, 0, 0, 2, 12, 0, 0, 0, 0, 0, 8, 0, 43, 0, 43, 33, 0, 0, 0, 11, 0, 11, 20, 18, 0, 0, 0, 0, 0, 0, 1, 17, 0, 0, 1, 0, 3, 0, 0, 4, 0, 0, 0, 0, 0, 0, 0, 2, 0, 0, 1, 2, 0, 0, 0, 0, 0, 0, 0, 5, 0, 1, 0, 0, 1, 0, 0, 0, 0, 1, 0, 14, 2, 0, 2, 0, 0, 0, 2, 2, 0, 3, 0, 0, 3, 14, 0, 0, 0, 0, 0, 0, 0, 0, 0, 0, 0, 0, 0, 13, 0, 0, 44, 0, 2, 0, 0, 0, 0, 0, 0, 45, 0, 10, 3, 0, 0, 0, 11, 0, 0, 0, 10, 0, 0, 0, 1, 0, 0, 0, 0, 0, 1, 0, 0, 0, 4, 0, 3, 0, 73, 0, 0, 3, 0, 0, 1, 0, 52, 0, 0, 0, 3, 3, 0, 0, 0, 0, 12, 0, 0, 0, 0, 0, 0, 129, 0, 0, 0, 0, 0, 0, 0, 0, 0, 0, 186, 4, 0, 0, 8, 0, 0, 0, 0, 0, 0, 1, 0, 0, 3, 0, 0, 87, 0, 0, 1, 2, 0, 0, 7, 0, 4, 0, 0, 0, 0, 1, 0, 0, 10, 0, 0, 0, 9, 6, 9, 52, 4, 0, 0, 0, 0, 0, 0, 0, 0, 6, 19, 0, 0, 0, 0, 0, 12, 0, 0, 0, 0, 1, 0, 0, 5, 24, 9, 18, 0, 0, 1, 2, 0, 0, 9, 1, 0, 0, 0, 0, 0, 0, 0, 0, 0, 2, 5, 0, 0, 3, 1, 3, 1, 7, 0, 0, 0, 1, 0, 2, 0, 37, 0, 2, 0, 0, 0, 0, 26, 0, 0, 0, 0, 0, 0, 0, 0, 1, 8, 0, 2, 9, 0, 0, 1, 2, 1, 16, 0, 0, 1, 2, 0, 38, 0, 0, 0, 0, 0, 0, 0, 1, 1, 0, 0, 19, 3, 0, 0, 0, 1, 0, 28, 0, 0, 5, 0, 7, 1, 0, 0, 1, 0, 0, 0, 0, 0, 2, 0, 0, 4, 0, 0, 0, 0, 1, 18, 11, 0, 0, 0, 2, 6, 0, 0, 1, 0, 0, 0, 0, 41, 0, 5, 0, 0, 6, 0, 0, 72, 12, 0, 0, 0, 0, 0, 0, 1, 0, 0, 0, 0, 0, 6, 0, 0, 4, 1, 0, 0, 0, 0, 0, 4, 0, 0, 0, 1, 0, 0, 0, 0, 0, 0, 0, 0, 13, 0, 0, 0, 0, 0, 0, 0, 0, 0, 0, 1, 0, 0, 0, 8, 2, 0, 0, 0, 0, 0, 0, 3, 0, 22, 0, 0, 0, 0, 2, 1, 0, 0, 0, 0, 12, 0, 1, 0, 1, 13, 2, 0, 64, 44, 0, 0, 10, 0, 24, 0, 0, 0, 0, 0, 0, 0, 1, 0, 9, 7, 0, 0, 0, 0, 0, 0, 0, 10, 0, 78, 0, 0, 0, 2, 1, 2, 0, 0, 0, 1, 0, 0, 3, 0, 0, 42, 0, 0, 20, 20, 0, 0, 1, 0, 0, 0, 0, 4, 0, 0, 0, 0, 1, 14, 0, 0, 0, 9, 10, 0, 0, 1, 9, 0, 0, 28, 0, 61, 0, 0, 0, 0, 0, 0, 4, 0, 13, 20, 0, 0, 2, 0, 0, 0, 0, 0, 0, 0, 0, 0, 0, 0, 14, 0, 10, 0, 0, 0, 0, 0, 0, 0, 5, 3, 25, 0, 0, 2, 0, 0, 1, 2, 0, 0, 0, 24, 48, 0, 1, 0, 0, 1, 0, 2, 0, 10, 1, 0, 0, 1, 19, 5, 0, 9, 0, 0, 0, 0, 0, 0, 0, 3, 0, 0, 0, 5, 0, 0, 0, 0, 25, 0, 4, 0, 0, 0, 0, 0, 0, 0, 0, 0, 3, 26, 3, 0
Tearing-Down-the-Walls-How-Sandy-Weill-Fought-His-Way-to-the-Top-of-the-Financial-World.-.-, 0, 0, 0, 59, 126, 0, 0, 0, 54, 42, 1, 13, 1, 2, 0, 0, 9, 0, 0, 0, 0, 0, 0, 20, 0, 0, 0, 0, 2, 4, 0, 0, 0, 63, 0, 0, 0, 0, 75, 0, 261, 0, 16, 0, 0, 0, 185, 55, 0, 0, 0, 241, 0, 0, 593, 0, 0, 0, 0, 0, 78, 0, 0, 0, 79, 0, 0, 21, 0, 1, 0, 0, 0, 0, 2, 0, 0, 0, 30, 0, 0, 0, 0, 0, 0, 7, 0, 0, 0, 164, 0, 0, 5, 0, 0, 0, 1, 0, 3, 13, 18, 1, 0, 0, 0, 0, 0, 0, 37, 0, 0, 22, 0, 0, 0, 22, 0, 1, 1, 56, 0, 1, 0, 0, 3, 290, 1, 0, 0, 1, 15, 0, 0, 93, 0, 0, 1, 0, 0, 7, 0, 0, 0, 0, 0, 6, 103, 0, 0, 0, 0, 1, 11, 0, 17, 22, 0, 0, 33, 17, 1, 46, 0, 0, 2, 0, 10, 3, 13, 2, 0, 135, 3, 43, 6, 0, 2, 1, 72, 162, 0, 38, 0, 53, 0, 0, 0, 8, 0, 21, 0, 0, 3, 3, 280, 1, 0, 2, 8, 0, 0, 11, 0, 62, 0, 0, 3, 0, 15, 1, 37, 13, 5, 0, 11, 0, 1, 0, 0, 52, 0, 0, 0, 0, 0, 0, 0, 0, 6, 0, 5, 4, 0, 0, 0, 0, 10, 0, 0, 0, 0, 10, 5, 6, 0, 0, 0, 0, 1, 0, 34, 0, 0, 0, 376, 0, 54, 0, 187, 0, 0, 12, 5, 0, 0, 0, 1, 0, 0, 14, 1, 0, 27, 2, 124, 75, 10, 0, 0, 0, 34, 0, 0, 0, 15, 4, 0, 0, 6, 15, 0, 29, 1, 0, 13, 4, 0, 22, 0, 18, 1, 29, 0, 0, 0, 44, 28, 0, 0, 0, 22, 0, 0, 1, 0, 35, 0, 21, 0, 0, 6, 0, 0, 6, 0, 0, 0, 0, 29, 0, 0, 18, 0, 17, 0, 0, 0, 0, 0, 0, 1, 0, 0, 0, 0, 0, 64, 0, 0, 8, 0, 25, 0, 0, 192, 0, 0, 265, 0, 0, 12, 0, 2, 2, 0, 0, 4, 0, 9, 6, 0, 0, 1, 13, 0, 0, 12, 23, 2, 58, 0, 0, 45, 0, 0, 23, 0, 0, 6, 0, 97, 17, 0, 0, 0, 0, 0, 3, 0, 0, 0, 0, 3, 0, 1, 0, 0, 7, 0, 173, 1, 0, 0, 0, 14, 0, 0, 0, 0, 0, 0, 0, 0, 1, 0, 23, 0, 0, 64, 0, 0, 6, 0, 0, 7, 0, 0, 0, 49, 3, 9, 17, 0, 27, 81, 0, 0, 0, 0, 0, 0, 4, 1, 0, 61, 0, 59, 21, 0, 0, 0, 319, 0, 2, 7, 0, 162, 0, 0, 0, 0, 0, 0, 0, 0, 0, 0, 0, 0, 9, 0, 0, 3, 0, 0, 0, 43, 0, 4, 0, 0, 0, 0, 0, 0, 0, 5, 3, 17, 90, 0, 0, 0, 27, 0, 0, 0, 0, 0, 0, 0, 3437, 1, 1, 56, 150, 0, 15, 8, 0, 0, 0, 40, 0, 0, 104, 0, 2, 0, 13, 45, 0, 0, 5, 0, 3, 1, 22, 0, 0, 92, 7, 0, 5, 383, 0, 0, 1, 0, 3, 0, 0, 1, 0, 0, 0, 150, 0, 0, 14, 13, 0, 0, 0, 0, 0, 0, 29, 0, 0, 36, 2, 0, 5, 0, 0, 3, 116, 1, 1, 4, 0, 0, 0, 86, 5, 0, 0, 1, 0, 0, 0, 11, 0, 0, 21, 0, 3, 0, 42, 0, 0, 0, 23, 0, 0, 0, 0, 1, 10, 29, 3, 300, 0, 33, 0, 0, 8, 3, 0, 0, 2, 0, 0, 92, 0, 0, 25, 1, 4, 266, 26, 0, 28, 72, 0, 123, 0, 0, 18, 0, 45, 0, 0, 6, 0, 60, 0, 0, 0, 0, 0, 49, 0, 1, 3, 0, 401, 1, 0, 1, 118, 23, 0, 0, 0, 16, 0, 2, 0, 0, 0, 0, 0, 1, 22, 20, 132, 0, 0, 1, 147, 0, 0, 41, 3, 9, 1, 203, 0, 0, 23, 0, 0, 3, 1, 0, 2, 0, 3, 59, 22, 0, 0, 0, 0, 75, 14, 0, 0, 121, 160, 0, 0, 39, 25, 23, 10, 0, 0, 0, 3, 5, 0, 0, 34, 0, 5, 0, 56, 0, 0, 40, 6, 0, 0, 0, 0, 0, 0, 0, 0, 0, 0, 0, 9, 0, 0, 0, 14, 0, 2, 34, 0, 0, 0, 0, 20, 0, 0, 25, 0, 0, 0, 0, 5, 0, 0, 59, 0, 0, 0, 0, 52, 1, 1, 9, 0, 0, 7, 3, 15, 0, 7, 8, 66, 3, 0, 28, 6, 0, 4, 0, 36, 1, 0, 83, 6, 0, 0, 0, 0, 0, 0, 0, 0, 0, 28, 0, 0, 0, 18, 0, 2, 0, 0, 0, 0, 59, 0, 0, 1, 17, 0, 21, 0, 0, 9, 9, 0, 66, 0, 19, 30, 0, 2, 0, 0, 2, 1, 0, 0, 0, 0, 1, 2, 9, 23, 42, 24, 16, 0, 4, 0, 0, 0, 10, 0, 0, 0, 1, 38, 0, 0, 0, 0, 3, 0, 1, 0, 0, 8, 5, 1, 0, 5, 11, 10, 0, 52, 25, 20, 24, 0, 0, 0, 9, 0, 1, 116, 27, 0, 0, 22, 0, 23, 0, 9, 2, 0, 3, 23, 20, 1, 3, 3, 0, 0, 0, 0, 0, 0, 0, 15, 0, 0, 0, 0, 2, 0, 0, 0, 0, 0, 1, 22, 0, 0, 0, 0, 0, 0, 6, 0, 29, 0, 0, 2, 8, 1, 0, 0, 26, 0, 0, 1, 0, 0, 0, 0, 7, 0, 0, 0, 3, 0, 1, 48, 2, 0, 8, 8, 0, 12, 0, 9, 0, 1, 0, 0, 0, 0, 0, 0, 10, 3, 0, 0, 33, 0, 0, 0, 40, 0, 0, 0, 49, 0, 0, 98, 0, 0, 0, 151, 0, 10, 5, 0, 0, 0, 5, 0, 0, 0, 0, 0, 0, 52, 28, 9, 0, 0, 0, 3, 3, 4, 0, 11, 11, 50, 1, 0, 0, 84, 0, 0, 0, 0, 0, 56, 11, 1, 0, 0, 10, 0, 0, 0, 2, 0, 40, 0, 0, 0, 1, 0, 0, 2, 0, 0, 2, 0, 101, 0, 0, 64, 1, 0, 0, 45, 0, 6, 0, 2, 0, 246, 1, 11, 0, 0, 0, 0, 55, 1, 0, 0, 39, 0, 33, 0, 0, 0, 108, 277, 0, 0, 0, 4, 39, 0, 0, 0, 0, 103, 265, 0, 7, 0, 0, 10, 133, 21, 0, 0, 44, 48, 1, 0, 0, 7, 0, 33, 0, 351, 0, 0, 0, 60, 33, 0, 0, 0, 0, 0, 0, 4, 114, 0, 0, 0, 0, 1, 17, 0, 20, 0, 534, 0, 0, 0, 0, 2, 0, 61, 112, 13, 0, 0, 0, 0, 0, 0, 17, 50, 353, 0, 2, 0, 21, 0, 0, 0, 0, 0, 0, 0, 0, 0, 0, 140, 0, 0, 12, 17, 0, 0, 33, 0, 0, 0, 0, 140, 0, 0, 0, 0, 0, 0, 0, 0, 0, 0, 3, 8, 0, 0, 79, 2, 0, 0, 2, 0, 0, 39, 0, 3, 21, 259, 1, 50, 0, 0, 0, 0, 0, 0, 0, 0, 0, 0, 4, 57, 142, 0, 96, 18, 20, 0, 9, 0, 0, 1, 1, 18, 0, 41, 12, 0, 0, 0, 18, 3, 0, 94, 58, 1, 0, 0, 2, 28, 1, 0, 0, 0, 14, 0, 0, 0, 1, 4, 0, 19, 55, 0, 0, 0, 0, 0, 0, 2, 29, 0, 0, 0, 9, 11, 0, 0, 0, 0, 2, 0, 0, 1, 0, 0, 6, 0, 0, 0, 0, 0, 0, 0, 21, 0, 0, 0, 684, 37, 0, 0, 34, 0, 0, 0, 1, 2, 1, 86, 0, 0, 196, 34, 0, 358, 6, 0, 0, 0, 0, 0, 5, 0, 42, 0, 76, 2, 0, 13, 0, 0, 76, 5, 0, 0, 56, 2, 37, 101, 95, 0, 0, 0, 0, 0, 0, 0, 0, 0, 3, 104, 0, 3, 0, 0, 1, 0, 0, 0, 0, 11, 0, 0, 0, 285, 50, 137, 17, 0, 12, 1, 0, 0, 32, 10, 0, 0, 0, 1, 0, 0, 0, 4, 0, 0, 0, 38, 0, 9, 8, 1, 0, 79, 0, 0, 0, 26, 1, 8, 0, 55, 0, 29, 0, 1, 0, 6, 89, 0, 1, 0, 0, 0, 0, 0, 3, 7, 169, 0, 1, 22, 0, 0, 15, 10, 1, 41, 0, 0, 2, 17, 0, 72, 0, 87, 0, 0, 0, 13, 0, 12, 1, 0, 0, 0, 22, 0, 0, 0, 46, 9, 17, 0, 0, 17, 0, 32, 3, 0, 0, 0, 0, 0, 0, 0, 0, 1, 1, 0, 2, 0, 0, 0, 3, 40, 0, 34, 0, 0, 0, 8, 12, 0, 0, 13, 0, 0, 1, 0, 73, 1, 4, 1, 0, 0, 5, 0, 423, 82, 5, 0, 0, 0, 0, 138, 104, 0, 0, 1, 5, 0, 3, 2, 0, 0, 37, 0, 0, 0, 93, 0, 19, 0, 1, 0, 12, 0, 0, 0, 0, 3, 0, 0, 0, 29, 0, 0, 0, 61, 0, 0, 0, 0, 0, 0, 42, 0, 0, 15, 11, 5, 0, 0, 0, 0, 0, 0, 4, 0, 0, 0, 0, 0, 1, 10, 0, 0, 0, 0, 1, 1, 0, 3, 0, 7, 18, 0, 0, 104, 0, 0, 0, 103, 21, 88, 0, 8, 194, 7, 0, 0, 2, 0, 0, 106, 0, 0, 0, 0, 0, 0, 0, 0, 62, 0, 0, 0, 0, 0, 24, 0, 0, 0, 0, 0, 12, 1, 0, 12, 5, 155, 130, 0, 0, 82, 103, 0, 0, 15, 0, 0, 1, 26, 18, 3, 0, 0, 0, 1, 0, 0, 196, 0, 56, 19, 0, 0, 1, 29, 0, 0, 110, 0, 91, 0, 0, 0, 0, 0, 2, 49, 1, 258, 76, 0, 0, 0, 0, 1, 2, 0, 29, 3, 0, 0, 0, 0, 1, 66, 0, 26, 0, 0, 0, 21, 0, 0, 0, 0, 6, 30, 0, 0, 31, 0, 0, 14, 0, 0, 0, 56, 10, 88, 0, 7, 0, 11, 40, 0, 1, 5, 0, 6, 0, 0, 5, 408, 43, 0, 36, 0, 2, 1, 4, 0, 0, 0, 31, 0, 0, 4, 295, 0, 0, 0, 24, 79, 0, 9, 0, 0, 0, 0, 0, 0, 0, 6, 0, 38, 151, 10, 1
The Accidental-Billionaires-The-Founding-of-Facebook-A-Tale-of-Sex_-Money_-Genius-and-Betrayal-by-Be, 0, 0, 0, 7, 6, 0, 0, 0, 0, 17, 0, 4, 1, 0, 0, 0, 0, 0, 0, 0, 0, 0, 0, 49, 0, 0, 0, 0, 0, 0, 0, 0, 0, 0, 0, 0, 0, 0, 26, 0, 1, 0, 6, 0, 0, 0, 0, 0, 0, 0, 0, 2, 0, 0, 0, 0, 0, 0, 0, 0, 8, 0, 0, 0, 0, 0, 0, 4, 0, 0, 0, 0, 0, 0, 0, 0, 0, 0, 4, 0, 0, 0, 0, 0, 0, 0, 0, 0, 0, 13, 0, 0, 4, 0, 0, 0, 0, 0, 1, 4, 1, 2, 0, 0, 0, 0, 0, 0, 5, 0, 0, 12, 0, 0, 0, 4, 0, 0, 0, 0, 0, 0, 0, 0, 7, 83, 0, 0, 0, 0, 181, 0, 0, 0, 0, 0, 0, 0, 0, 0, 0, 0, 0, 0, 0, 0, 12, 0, 0, 21, 0, 33, 0, 0, 7, 0, 5, 0, 15, 0, 0, 51, 0, 0, 0, 0, 2, 1, 0, 0, 0, 0, 0, 8, 0, 0, 2, 0, 53, 0, 0, 7, 0, 6, 0, 0, 0, 59, 0, 0, 0, 0, 0, 0, 2, 0, 0, 0, 1, 0, 0, 11, 0, 27, 0, 0, 1, 0, 1, 0, 4, 5, 4, 0, 0, 0, 0, 0, 0, 8, 0, 0, 0, 0, 0, 0, 0, 0, 3, 0, 0, 0, 0, 0, 0, 0, 12, 0, 3, 0, 0, 2, 0, 0, 59, 0, 0, 0, 0, 0, 11, 0, 0, 0, 10, 0, 18, 0, 0, 0, 0, 1, 111, 0, 0, 0, 0, 3, 0, 16, 1, 0, 3, 2, 7, 18, 4, 0, 1, 39, 15, 0, 0, 0, 15, 590, 0, 0, 1, 9, 0, 15, 27, 0, 0, 19, 0, 14, 5, 1, 0, 0, 0, 0, 0, 5, 0, 0, 0, 6, 24, 0, 0, 0, 8, 0, 0, 1, 0, 0, 10, 0, 0, 3, 0, 0, 0, 0, 22, 0, 0, 9, 0, 1, 0, 0, 0, 0, 0, 0, 0, 0, 0, 0, 0, 0, 11, 0, 0, 2, 0, 2, 0, 0, 0, 0, 0, 21, 0, 0, 10, 0, 0, 0, 0, 0, 3, 0, 9, 3, 0, 0, 1, 1, 0, 0, 1, 1, 0, 2, 0, 0, 5, 142, 0, 2, 4, 0, 3, 0, 3, 0, 0, 0, 0, 0, 0, 0, 36, 0, 0, 0, 0, 0, 0, 0, 0, 0, 0, 40, 4, 0, 0, 6, 1, 0, 0, 0, 0, 0, 0, 0, 3, 0, 0, 7, 0, 0, 82, 0, 0, 0, 0, 0, 0, 0, 27, 0, 88, 2, 0, 25, 0, 0, 55, 0, 0, 0, 0, 0, 0, 0, 0, 0, 69, 0, 23, 6, 0, 0, 0, 164, 2, 0, 2, 0, 0, 0, 0, 0, 0, 0, 0, 0, 0, 0, 0, 0, 0, 2, 0, 0, 0, 0, 0, 0, 3, 0, 0, 0, 32, 0, 0, 0, 0, 0, 12, 0, 13, 0, 0, 0, 0, 18, 0, 0, 0, 0, 0, 0, 0, 1, 0, 0, 13, 56, 0, 10, 0, 0, 0, 0, 8, 0, 0, 5, 0, 1, 0, 0, 3, 0, 0, 0, 0, 0, 1, 93, 0, 0, 47, 0, 0, 1, 0, 0, 0, 73, 0, 0, 0, 0, 0, 0, 0, 0, 5, 0, 0, 1, 22, 0, 0, 0, 0, 0, 0, 4, 0, 0, 11, 0, 0, 5, 0, 0, 0, 12, 0, 0, 0, 0, 0, 0, 0, 11, 0, 0, 0, 0, 0, 0, 0, 0, 0, 5, 0, 0, 0, 3, 0, 0, 0, 31, 0, 0, 0, 0, 2, 2, 9, 0, 21, 0, 0, 0, 0, 5, 4, 0, 0, 0, 0, 0, 54, 0, 0, 11, 0, 9, 0, 21, 0, 4, 0, 0, 0, 0, 0, 1, 0, 8, 0, 0, 0, 0, 24, 1, 0, 0, 0, 0, 24, 0, 0, 0, 0, 9, 0, 0, 0, 0, 12, 0, 0, 0, 2, 0, 0, 0, 0, 0, 0, 0, 0, 2, 0, 0, 0, 0, 0, 12, 0, 0, 20, 0, 0, 0, 1, 4, 0, 12, 0, 0, 0, 3, 0, 0, 0, 0, 0, 0, 0, 0, 0, 0, 26, 5, 0, 0, 0, 36, 0, 0, 0, 0, 5, 0, 0, 0, 0, 0, 0, 0, 0, 28, 0, 1, 0, 0, 0, 0, 2, 1, 0, 0, 0, 0, 0, 0, 0, 0, 0, 0, 0, 4, 0, 0, 0, 36, 0, 0, 40, 0, 0, 0, 0, 0, 0, 0, 0, 0, 0, 0, 0, 0, 0, 0, 6, 0, 0, 0, 0, 6, 0, 0, 3, 0, 0, 0, 5, 0, 0, 9, 1, 15, 0, 0, 8, 3, 0, 0, 0, 67, 0, 0, 2, 0, 0, 0, 0, 0, 0, 0, 0, 0, 0, 13, 0, 0, 0, 16, 0, 0, 0, 0, 0, 0, 0, 0, 0, 0, 17, 0, 0, 0, 0, 0, 7, 0, 3, 0, 3, 1, 0, 0, 4, 1, 0, 0, 0, 0, 0, 0, 0, 0, 2, 7, 9, 5, 18, 0, 0, 74, 0, 0, 44, 0, 0, 0, 0, 1, 0, 0, 0, 0, 0, 0, 0, 0, 0, 19, 0, 2, 0, 0, 133, 26, 0, 1, 0, 6, 6, 1, 0, 0, 19, 0, 0, 103, 1, 0, 0, 2, 0, 27, 0, 48, 2, 0, 1, 8, 0, 0, 0, 2, 0, 0, 61, 0, 0, 0, 0, 0, 0, 0, 0, 0, 0, 0, 0, 0, 0, 0, 0, 0, 0, 0, 0, 0, 0, 0, 2, 16, 2, 0, 0, 0, 0, 32, 0, 0, 7, 0, 0, 1, 0, 0, 0, 0, 2, 0, 0, 5, 7, 0, 0, 49, 0, 0, 5, 0, 0, 2, 0, 2, 0, 2, 0, 0, 0, 3, 0, 0, 2, 0, 0, 0, 12, 0, 0, 0, 16, 0, 0, 0, 37, 0, 0, 60, 0, 0, 0, 46, 0, 5, 0, 0, 0, 0, 5, 0, 0, 0, 0, 0, 0, 26, 10, 1, 0, 0, 0, 2, 68, 0, 0, 8, 1, 0, 1, 0, 0, 20, 0, 0, 0, 0, 0, 22, 0, 1, 0, 0, 2, 0, 0, 0, 1, 0, 4, 0, 0, 0, 0, 0, 0, 1, 0, 0, 4, 0, 0, 0, 0, 3, 0, 99, 0, 3, 0, 2, 0, 0, 0, 0, 0, 0, 0, 0, 0, 0, 66, 2, 0, 0, 4, 0, 14, 0, 0, 0, 2, 0, 0, 0, 0, 0, 8, 0, 0, 0, 0, 0, 6, 0, 1, 0, 0, 0, 5, 0, 0, 1, 39, 9, 0, 0, 0, 2, 0, 1, 0, 28, 0, 0, 0, 26, 7, 0, 0, 0, 0, 0, 0, 0, 10, 0, 0, 0, 0, 0, 9, 0, 2, 0, 3, 16, 17, 0, 0, 3, 0, 37, 16, 0, 0, 0, 0, 0, 0, 0, 1, 22, 0, 0, 0, 0, 1, 0, 0, 0, 0, 0, 0, 0, 0, 0, 0, 0, 0, 0, 6, 2, 0, 0, 0, 0, 0, 0, 0, 2, 0, 0, 0, 22, 0, 0, 0, 0, 0, 10, 2, 10, 0, 0, 0, 0, 0, 0, 4, 0, 0, 0, 0, 0, 3, 23, 0, 0, 0, 0, 0, 0, 0, 0, 0, 0, 0, 0, 0, 12, 0, 0, 33, 1, 2, 0, 0, 0, 0, 0, 7, 72, 0, 58, 7, 0, 0, 0, 9, 5, 0, 0, 2, 0, 0, 0, 0, 0, 0, 0, 0, 0, 0, 0, 0, 0, 1, 0, 0, 0, 4, 0, 0, 0, 0, 0, 0, 0, 26, 0, 0, 0, 0, 2, 0, 0, 0, 0, 1, 0, 0, 0, 0, 0, 6, 0, 0, 0, 0, 0, 0, 0, 0, 0, 0, 0, 131, 3, 0, 0, 2, 0, 0, 0, 0, 1, 7, 0, 0, 0, 27, 0, 0, 22, 1, 0, 0, 0, 0, 0, 0, 0, 6, 0, 0, 0, 0, 2, 0, 0, 5, 0, 0, 0, 5, 1, 28, 99, 2, 0, 0, 0, 0, 0, 0, 0, 0, 0, 0, 0, 0, 0, 0, 0, 0, 0, 0, 0, 0, 1, 0, 0, 6, 60, 11, 6, 0, 0, 15, 3, 0, 0, 2, 1, 0, 0, 0, 2, 119, 0, 0, 0, 0, 3, 0, 0, 0, 0, 0, 0, 0, 0, 0, 0, 0, 18, 0, 1, 0, 14, 0, 1, 0, 3, 0, 1, 15, 0, 0, 0, 0, 0, 0, 0, 0, 0, 14, 0, 0, 45, 0, 0, 0, 0, 0, 3, 0, 0, 0, 703, 0, 40, 0, 0, 0, 1, 5, 2, 0, 0, 3, 0, 0, 0, 1, 0, 0, 0, 3, 1, 228, 0, 0, 4, 0, 19, 0, 0, 0, 0, 1, 0, 0, 0, 0, 0, 0, 3, 0, 0, 0, 0, 0, 0, 7, 1, 0, 0, 0, 1, 3, 0, 0, 0, 0, 0, 0, 0, 8, 0, 1, 0, 0, 0, 0, 0, 69, 0, 0, 0, 0, 0, 0, 0, 1, 0, 0, 0, 0, 0, 5, 0, 0, 0, 1, 0, 0, 0, 0, 0, 2, 0, 2, 0, 3, 0, 70, 0, 0, 0, 0, 0, 0, 19, 0, 0, 0, 0, 0, 0, 0, 222, 0, 0, 3, 0, 0, 0, 7, 0, 0, 0, 0, 0, 0, 0, 3, 0, 22, 0, 0, 0, 0, 0, 0, 0, 0, 0, 0, 1, 0, 0, 0, 1, 1, 0, 0, 106, 3, 0, 0, 18, 6, 38, 0, 0, 3, 1, 0, 0, 0, 0, 0, 17, 2, 0, 0, 0, 0, 0, 0, 0, 10, 0, 7, 0, 0, 0, 2, 1, 1, 0, 0, 0, 0, 1, 0, 4, 0, 0, 83, 0, 0, 12, 11, 0, 0, 0, 0, 0, 0, 11, 12, 0, 0, 0, 0, 5, 0, 0, 0, 0, 3, 8, 0, 0, 0, 4, 0, 0, 27, 0, 36, 0, 0, 0, 0, 0, 0, 12, 0, 35, 44, 2, 0, 0, 0, 0, 1, 0, 0, 0, 0, 0, 0, 0, 0, 23, 0, 7, 0, 0, 0, 2, 0, 32, 0, 10, 6, 5, 0, 0, 3, 0, 0, 2, 0, 0, 0, 0, 32, 44, 0, 0, 0, 0, 2, 0, 0, 1, 0, 0, 0, 0, 0, 0, 64, 0, 10, 0, 0, 0, 0, 0, 0, 0, 5, 0, 0, 0, 7, 0, 0, 0, 0, 91, 0, 4, 0, 0, 0, 0, 0, 0, 19, 0, 0, 1, 71, 7, 0
The Anglo-American Establishment by Carroll Quigley, 0, 0, 0, 20, 5, 0, 0, 0, 0, 71, 0, 43, 2, 0, 0, 0, 5, 0, 0, 0, 0, 0, 0, 3, 0, 0, 0, 0, 67, 0, 0, 0, 0, 0, 0, 0, 0, 0, 128, 0, 24, 0, 383, 0, 0, 0, 0, 3, 0, 0, 0, 100, 33, 0, 0, 4, 0, 0, 4, 54, 134, 0, 0, 0, 4, 0, 0, 157, 0, 0, 0, 0, 2, 14, 3, 0, 0, 0, 39, 0, 0, 0, 0, 0, 0, 6, 0, 22, 0, 1, 0, 0, 5, 0, 0, 0, 0, 6, 4, 1, 12, 0, 0, 0, 0, 0, 0, 0, 7, 0, 0, 47, 0, 138, 1, 16, 0, 0, 2, 0, 0, 0, 0, 0, 21, 79, 0, 0, 0, 0, 2, 0, 0, 0, 0, 0, 1, 0, 0, 43, 0, 0, 0, 0, 0, 0, 79, 0, 0, 0, 0, 0, 0, 0, 8, 20, 0, 0, 22, 0, 0, 31, 0, 0, 0, 0, 20, 1, 9, 78, 0, 4, 0, 25, 0, 0, 0, 0, 252, 101, 0, 82, 0, 64, 0, 0, 0, 12, 0, 28, 0, 0, 4, 1, 9, 1, 0, 0, 40, 0, 0, 0, 1, 55, 37, 0, 1, 0, 7, 2, 18, 5, 0, 0, 173, 0, 0, 0, 0, 0, 0, 0, 0, 0, 5, 0, 0, 0, 0, 0, 0, 0, 0, 0, 0, 45, 1, 0, 0, 55, 0, 8, 4, 0, 0, 0, 0, 4, 0, 0, 12, 0, 0, 0, 1, 0, 107, 83, 0, 0, 0, 75, 1, 0, 0, 0, 1, 0, 0, 13, 1, 0, 12, 7, 38, 5, 0, 0, 0, 0, 20, 0, 0, 0, 5, 0, 0, 1, 8, 0, 0, 60, 0, 1, 0, 9, 0, 9, 6, 22, 2, 0, 161, 0, 0, 85, 84, 0, 0, 0, 17, 0, 0, 0, 0, 0, 2, 1, 0, 0, 3, 0, 0, 2, 0, 0, 0, 0, 82, 0, 0, 3, 0, 113, 3, 0, 0, 2, 0, 0, 0, 0, 73, 0, 0, 0, 26, 0, 0, 477, 2, 6, 1, 0, 9, 0, 238, 77, 0, 0, 9, 0, 2, 0, 0, 12, 17, 0, 0, 0, 0, 0, 0, 0, 0, 0, 95, 3, 0, 1, 0, 0, 7, 0, 0, 6, 109, 0, 17, 0, 10, 26, 0, 0, 1160, 0, 0, 1, 0, 0, 0, 0, 0, 0, 0, 0, 0, 0, 0, 17, 2, 0, 0, 0, 4, 1, 115, 0, 0, 61, 0, 0, 2, 0, 0, 7, 0, 0, 144, 0, 0, 0, 0, 0, 0, 0, 0, 0, 31, 1, 0, 2, 0, 12, 91, 0, 0, 0, 0, 0, 0, 0, 0, 0, 1, 0, 122, 4, 0, 0, 0, 406, 0, 0, 25, 0, 187, 0, 0, 4, 0, 0, 0, 0, 0, 0, 0, 0, 84, 28, 0, 0, 4, 0, 0, 0, 32, 0, 0, 0, 0, 0, 0, 4, 0, 0, 0, 2, 11, 0, 0, 0, 0, 4, 45, 0, 0, 11, 0, 0, 0, 0, 36, 0, 140, 18, 0, 0, 1, 5, 4, 0, 78, 0, 0, 3, 0, 6, 0, 0, 4, 0, 0, 0, 0, 0, 1, 57, 0, 0, 2, 97, 0, 3, 0, 0, 0, 0, 0, 1, 0, 1, 2, 0, 0, 0, 0, 0, 0, 3, 0, 0, 0, 0, 0, 0, 0, 12, 0, 0, 63, 0, 0, 0, 0, 0, 0, 20, 0, 0, 205, 0, 0, 0, 0, 3, 0, 0, 0, 0, 0, 1, 14, 0, 0, 2, 0, 13, 26, 85, 0, 0, 0, 104, 0, 0, 0, 74, 1, 115, 15, 0, 3, 0, 185, 0, 0, 38, 90, 0, 0, 0, 0, 0, 23, 7, 0, 20, 0, 0, 0, 148, 0, 2, 0, 0, 13, 0, 0, 0, 0, 11, 0, 0, 97, 0, 17, 0, 0, 0, 1, 2, 5, 0, 0, 2, 1, 11, 1, 1, 0, 0, 19, 0, 3, 0, 19, 0, 53, 0, 0, 0, 0, 0, 0, 22, 1, 0, 0, 0, 0, 2, 0, 0, 1, 0, 0, 0, 30, 2, 140, 4, 0, 0, 284, 2, 2, 0, 0, 0, 0, 1, 0, 0, 0, 0, 1, 69, 0, 0, 0, 64, 0, 0, 26, 0, 7, 0, 0, 0, 1, 0, 0, 3, 0, 11, 0, 0, 56, 11, 0, 0, 41, 1, 0, 0, 0, 0, 0, 0, 0, 0, 0, 0, 0, 13, 0, 0, 0, 25, 0, 5, 75, 0, 0, 0, 0, 0, 0, 0, 74, 0, 0, 0, 0, 0, 0, 0, 10, 0, 0, 0, 0, 18, 0, 20, 20, 0, 0, 27, 4, 4, 0, 1, 6, 158, 3, 0, 19, 5, 0, 0, 0, 0, 0, 0, 10, 0, 0, 0, 0, 0, 0, 0, 0, 0, 1, 12, 0, 0, 40, 0, 0, 0, 1, 0, 0, 0, 198, 0, 0, 0, 10, 0, 1, 0, 0, 7, 3, 0, 5, 0, 25, 0, 0, 0, 0, 0, 0, 172, 0, 0, 0, 0, 672, 0, 0, 34, 3, 12, 5, 0, 26, 0, 0, 0, 76, 3, 0, 0, 328, 1, 0, 0, 0, 0, 2, 0, 80, 0, 0, 0, 2, 0, 0, 0, 1, 0, 15, 175, 2, 19, 0, 0, 0, 1, 0, 0, 2, 94, 0, 0, 271, 21, 0, 20, 0, 5, 1, 0, 0, 3, 2, 0, 0, 1, 0, 0, 0, 0, 0, 0, 0, 394, 0, 0, 0, 0, 0, 0, 0, 0, 0, 3, 3, 33, 0, 20, 0, 0, 0, 0, 50, 0, 83, 0, 0, 0, 0, 0, 0, 0, 8, 0, 0, 0, 0, 0, 0, 0, 31, 0, 0, 0, 0, 0, 0, 0, 2, 0, 27, 0, 0, 9, 0, 0, 0, 0, 0, 1, 0, 0, 0, 0, 173, 0, 0, 0, 7, 0, 0, 0, 79, 0, 1, 1, 34, 0, 0, 53, 0, 48, 0, 33, 0, 30, 1, 0, 0, 0, 0, 0, 3, 0, 0, 1, 43, 0, 14, 2, 0, 0, 0, 3, 0, 2, 0, 0, 0, 0, 0, 15, 0, 41, 0, 0, 1, 1, 0, 25, 68, 0, 0, 4, 232, 0, 0, 0, 0, 0, 25, 0, 0, 0, 16, 0, 0, 0, 0, 0, 224, 0, 70, 0, 0, 33, 0, 0, 0, 0, 0, 0, 0, 0, 26, 1, 5, 3, 8, 0, 0, 0, 54, 3, 0, 0, 20, 0, 0, 0, 0, 0, 25, 0, 0, 41, 0, 0, 73, 0, 95, 0, 0, 0, 47, 0, 14, 0, 30, 2, 1, 0, 0, 0, 54, 56, 0, 0, 0, 7, 0, 24, 0, 174, 0, 0, 0, 5, 123, 0, 0, 0, 0, 0, 2, 4, 83, 0, 0, 0, 0, 0, 6, 1, 7, 0, 18, 0, 0, 0, 0, 0, 0, 37, 0, 0, 0, 0, 0, 0, 0, 0, 0, 58, 0, 0, 0, 0, 17, 0, 0, 0, 0, 0, 36, 0, 0, 0, 0, 0, 0, 0, 28, 15, 0, 0, 0, 0, 0, 0, 9, 6, 0, 0, 0, 0, 0, 0, 95, 0, 0, 3, 1, 6, 0, 0, 0, 0, 0, 0, 3, 0, 0, 0, 27, 28, 113, 36, 0, 0, 0, 0, 0, 0, 0, 0, 0, 0, 0, 0, 0, 125, 0, 0, 49, 5, 7, 31, 1, 0, 0, 0, 7, 144, 0, 7, 0, 0, 0, 0, 3, 150, 0, 0, 4, 4, 0, 0, 8, 0, 0, 0, 0, 0, 17, 0, 0, 0, 0, 55, 0, 11, 5, 0, 0, 0, 0, 0, 0, 0, 26, 0, 0, 0, 12, 0, 0, 0, 0, 0, 5, 0, 0, 0, 34, 0, 2, 0, 0, 0, 0, 0, 0, 0, 10, 0, 0, 0, 50, 0, 0, 0, 15, 0, 2, 86, 0, 1, 0, 18, 0, 0, 30, 0, 0, 24, 2, 0, 0, 1, 0, 0, 13, 0, 9, 0, 0, 1, 0, 1, 34, 0, 83, 3, 0, 0, 91, 0, 2, 18, 6, 0, 0, 0, 0, 3, 0, 0, 0, 4, 0, 0, 0, 0, 0, 0, 0, 0, 0, 0, 0, 4, 0, 0, 0, 77, 6, 108, 0, 0, 14, 8, 0, 0, 61, 8, 0, 0, 0, 2, 0, 0, 0, 65, 0, 19, 0, 194, 0, 10, 114, 0, 5, 0, 0, 0, 0, 0, 93, 66, 0, 29, 1, 210, 2, 70, 0, 147, 90, 210, 0, 0, 0, 0, 0, 118, 0, 170, 2, 0, 0, 2, 0, 0, 51, 30, 29, 4, 0, 0, 0, 9, 0, 40, 0, 23, 0, 10, 0, 0, 0, 8, 0, 0, 0, 0, 4, 0, 0, 0, 2, 11, 0, 0, 0, 10, 0, 17, 90, 0, 0, 0, 1, 1, 0, 0, 0, 1, 0, 0, 2, 0, 0, 0, 0, 0, 0, 3, 0, 52, 0, 24, 43, 3, 0, 4, 0, 0, 0, 3, 11, 0, 5, 4, 0, 0, 1, 0, 18, 0, 7, 0, 0, 0, 0, 0, 7, 0, 0, 0, 5, 1, 1, 0, 18, 0, 382, 0, 0, 0, 0, 0, 15, 0, 0, 0, 23, 0, 0, 0, 24, 0, 0, 49, 43, 20, 0, 0, 0, 1, 0, 0, 7, 0, 0, 0, 166, 0, 0, 0, 0, 4, 0, 0, 0, 0, 0, 2, 0, 0, 0, 0, 1, 0, 0, 230, 0, 0, 0, 0, 0, 0, 53, 159, 0, 126, 13, 0, 0, 93, 0, 0, 0, 4, 81, 10, 0, 0, 13, 6, 0, 54, 2, 0, 0, 14, 0, 0, 0, 0, 86, 0, 0, 0, 0, 0, 0, 0, 0, 0, 8, 3, 29, 0, 1, 0, 42, 0, 56, 47, 5, 3, 20, 0, 0, 6, 51, 0, 0, 0, 0, 0, 2, 12, 14, 0, 0, 0, 0, 9, 0, 0, 0, 0, 31, 83, 0, 0, 3, 7, 0, 0, 55, 0, 0, 0, 0, 0, 0, 0, 0, 43, 0, 2, 9, 0, 0, 2, 0, 3, 2, 0, 0, 0, 0, 0, 0, 0, 0, 8, 6, 6, 91, 0, 0, 27, 0, 0, 53, 0, 4, 12, 0, 0, 4, 5, 0, 0, 0, 0, 73, 0, 40, 65, 0, 30, 1, 5, 0, 0, 0, 1, 0, 15, 0, 0, 0, 4, 94, 0, 0, 0, 0, 2, 0, 0, 0, 0, 10, 0, 0, 27, 60, 0, 0, 0, 0, 154, 0, 206, 0, 0, 0, 0, 0, 0, 0, 0, 0, 20, 46, 47, 0
The Animated Man A Life of Walt Disney by Michael Barrier (z-lib.org), 0, 0, 0, 37, 113, 0, 48, 0, 0, 32, 0, 6, 2, 0, 0, 4, 1, 1, 0, 0, 0, 0, 0, 14, 17, 0, 0, 1, 3, 0, 0, 0, 1, 0, 0, 0, 0, 0, 9, 0, 19, 0, 51, 0, 0, 0, 0, 0, 0, 0, 0, 93, 0, 0, 0, 10, 0, 0, 0, 0, 49, 0, 0, 0, 19, 0, 0, 28, 0, 13, 0, 0, 0, 0, 0, 5, 0, 0, 2, 0, 0, 0, 0, 0, 130, 53, 0, 0, 0, 60, 1, 0, 46, 0, 0, 0, 0, 0, 0, 0, 0, 0, 0, 0, 0, 0, 0, 5, 1, 1, 0, 59, 0, 0, 0, 14, 0, 0, 7, 0, 1, 0, 0, 0, 137, 180, 0, 0, 0, 0, 3, 0, 0, 0, 0, 43, 0, 0, 0, 5, 0, 0, 0, 0, 0, 6, 105, 0, 0, 0, 1, 0, 1, 0, 0, 10, 6, 0, 92, 1, 6, 75, 0, 0, 1, 0, 20, 56, 2, 1, 0, 2, 0, 17, 0, 0, 52, 0, 19, 4, 0, 41, 0, 24, 0, 0, 0, 165, 0, 2, 0, 0, 7, 3, 13, 1, 0, 0, 5, 0, 0, 11, 2, 42, 2, 0, 10, 0, 10, 0, 15, 55, 36, 0, 0, 0, 0, 0, 0, 11, 0, 0, 0, 0, 5, 0, 0, 0, 4, 0, 0, 4, 0, 0, 0, 0, 240, 0, 1, 0, 0, 16, 1, 0, 0, 0, 0, 2, 1, 0, 44, 0, 0, 0, 25, 0, 13, 8, 0, 0, 0, 2, 20, 2384, 179, 0, 3, 1, 0, 29, 0, 0, 22, 4, 5, 51, 1, 1, 10, 0, 218, 0, 0, 0, 11, 0, 0, 0, 0, 11, 0, 232, 16, 1, 0, 7, 0, 61, 2, 9, 8, 5, 1, 0, 0, 21, 20, 0, 0, 0, 38, 0, 1, 1, 0, 5, 0, 18, 0, 1, 11, 0, 0, 5, 0, 0, 0, 0, 62, 0, 0, 4, 0, 23, 4, 0, 0, 0, 0, 0, 474, 0, 0, 0, 0, 0, 23, 0, 0, 19, 1, 0, 3, 0, 18, 0, 1, 40, 0, 0, 15, 0, 39, 0, 0, 0, 229, 0, 13, 202, 0, 0, 0, 0, 0, 0, 6, 8, 0, 8, 0, 0, 3, 0, 0, 0, 1, 0, 6, 0, 5, 7, 0, 0, 0, 0, 0, 1, 0, 0, 0, 0, 0, 0, 0, 0, 0, 0, 0, 115, 3, 0, 0, 0, 18, 0, 0, 0, 0, 0, 0, 0, 22, 0, 0, 19, 0, 0, 181, 0, 0, 1, 0, 0, 0, 1, 0, 0, 68, 1, 0, 21, 47, 3, 124, 0, 79, 0, 1, 0, 0, 0, 0, 0, 56, 0, 49, 2, 0, 0, 23, 423, 0, 21, 3, 0, 7, 0, 0, 0, 0, 0, 0, 0, 0, 0, 0, 0, 0, 15, 0, 0, 3, 0, 0, 0, 0, 0, 92, 0, 0, 0, 0, 0, 0, 0, 12, 18, 33, 5, 0, 0, 0, 30, 0, 0, 0, 0, 0, 0, 0, 0, 0, 0, 17, 124, 0, 3, 0, 0, 0, 0, 10, 0, 57, 10, 0, 1, 0, 10, 23, 0, 0, 1, 0, 0, 5, 4, 0, 0, 0, 15, 0, 5, 1, 0, 723, 30, 0, 0, 0, 0, 4, 0, 0, 0, 4, 3, 15, 7, 0, 0, 0, 1, 0, 0, 0, 8, 0, 0, 24, 0, 0, 3, 0, 0, 46, 0, 3, 0, 0, 0, 0, 0, 16, 4, 0, 0, 0, 0, 0, 11, 2, 0, 0, 19, 0, 3, 2, 40, 24, 0, 0, 21, 0, 0, 0, 0, 4, 17, 20, 1, 54, 0, 3, 0, 0, 8, 17, 0, 0, 3, 0, 0, 134, 2, 0, 24, 26, 23, 0, 11, 0, 194, 0, 0, 42, 0, 0, 2, 0, 7, 0, 0, 51, 0, 50, 2, 0, 0, 0, 2, 1, 0, 0, 1, 0, 0, 0, 46, 0, 0, 10, 0, 0, 0, 2, 0, 3, 0, 0, 0, 0, 0, 0, 28, 0, 0, 0, 0, 4, 63, 0, 0, 46, 0, 0, 0, 13, 1, 0, 59, 0, 0, 0, 0, 7, 0, 0, 2, 13, 1, 0, 0, 0, 0, 9, 32, 0, 0, 0, 23, 0, 0, 16, 0, 7, 6, 0, 0, 3, 0, 0, 0, 0, 21, 0, 129, 0, 15, 0, 0, 0, 15, 0, 0, 0, 0, 0, 0, 0, 0, 0, 0, 0, 4, 99, 0, 0, 39, 0, 0, 32, 0, 0, 0, 265, 0, 0, 0, 28, 0, 0, 0, 0, 0, 0, 0, 9, 0, 1, 0, 0, 17, 0, 2, 17, 0, 0, 0, 7, 31, 0, 12, 15, 63, 2, 0, 19, 12, 0, 0, 0, 7, 0, 0, 28, 0, 0, 0, 0, 0, 0, 5, 0, 0, 0, 37, 0, 1, 0, 102, 0, 1, 0, 0, 0, 0, 9, 0, 0, 0, 33, 0, 0, 0, 0, 0, 11, 0, 0, 0, 9, 4, 1, 0, 2, 0, 0, 0, 1, 0, 0, 0, 0, 0, 13, 8, 6, 10, 10, 0, 3, 0, 12, 0, 8, 1, 0, 0, 0, 9, 0, 0, 0, 0, 2, 0, 0, 0, 0, 15, 1, 0, 0, 0, 40, 10, 2, 0, 0, 3, 3, 0, 0, 0, 6, 0, 1, 197, 6, 0, 2, 0, 0, 214, 47, 93, 2, 0, 13, 7, 17, 1, 0, 3, 0, 0, 1, 0, 0, 0, 0, 13, 0, 0, 0, 0, 0, 0, 0, 0, 0, 0, 0, 9, 0, 0, 0, 0, 0, 0, 5, 0, 15, 0, 0, 3, 0, 0, 0, 0, 16, 0, 0, 27, 0, 0, 0, 0, 6, 0, 0, 0, 0, 15, 0, 111, 5, 0, 9, 5, 0, 12, 0, 14, 0, 385, 2, 0, 0, 6, 22, 0, 5, 0, 0, 0, 6, 41, 0, 0, 14, 0, 2, 0, 22, 0, 0, 121, 1, 0, 0, 42, 0, 27, 1, 0, 0, 0, 2, 0, 0, 0, 0, 1, 1, 16, 16, 1, 0, 0, 0, 14, 6, 0, 0, 4, 11, 9, 2, 0, 0, 59, 0, 0, 0, 5, 0, 36, 5, 0, 0, 0, 23, 0, 0, 0, 1, 0, 24, 0, 0, 0, 0, 0, 0, 0, 0, 0, 2, 0, 12, 266, 0, 0, 0, 0, 0, 2, 0, 0, 0, 0, 6, 23, 0, 0, 0, 0, 0, 0, 95, 4, 0, 0, 28, 0, 84, 0, 0, 0, 1, 0, 0, 0, 0, 0, 21, 37, 0, 0, 0, 0, 0, 0, 8, 0, 0, 32, 12, 0, 0, 1, 44, 8, 2, 0, 0, 3, 0, 53, 0, 0, 8, 0, 0, 6, 11, 0, 0, 2, 0, 0, 0, 3, 26, 0, 0, 0, 2, 6, 45, 4, 15, 0, 18, 0, 0, 0, 0, 2, 0, 60, 5, 29, 0, 0, 44, 0, 0, 0, 7, 39, 0, 0, 0, 1, 54, 0, 0, 0, 0, 11, 0, 0, 0, 11, 0, 1, 0, 1, 0, 11, 0, 0, 0, 0, 0, 0, 6, 7, 0, 0, 0, 0, 1, 75, 0, 0, 0, 0, 4, 18, 0, 0, 0, 0, 0, 0, 0, 0, 0, 22, 0, 4, 2, 54, 1, 0, 0, 0, 0, 0, 0, 0, 0, 0, 0, 0, 0, 40, 1, 0, 100, 0, 9, 1, 0, 0, 0, 0, 1, 14, 0, 36, 2, 0, 0, 0, 24, 4, 97, 0, 26, 0, 0, 0, 7, 0, 0, 0, 0, 0, 1, 51, 0, 0, 1, 5, 3, 14, 20, 0, 0, 0, 0, 0, 0, 0, 251, 0, 0, 0, 2, 15, 0, 0, 0, 0, 149, 0, 0, 0, 0, 0, 2, 0, 0, 0, 0, 0, 0, 69, 4, 19, 0, 0, 116, 1, 29, 0, 8, 0, 0, 0, 3, 4, 0, 1, 0, 0, 28, 0, 0, 97, 5, 0, 5, 0, 4, 0, 8, 0, 174, 0, 9, 0, 0, 0, 0, 0, 32, 7, 0, 0, 0, 1, 35, 134, 16, 0, 0, 0, 0, 0, 0, 1, 0, 0, 0, 0, 0, 0, 0, 0, 0, 0, 0, 0, 0, 4, 0, 0, 0, 120, 14, 25, 18, 0, 8, 1, 21, 0, 9, 3, 0, 0, 0, 2, 0, 0, 0, 0, 0, 14, 288, 4, 0, 1, 0, 0, 0, 3, 0, 0, 0, 8, 2, 25, 0, 53, 0, 2, 0, 3, 0, 1, 36, 0, 0, 0, 0, 0, 0, 0, 0, 1, 12, 0, 85, 4, 1, 0, 11, 12, 14, 35, 0, 0, 0, 16, 79, 95, 0, 0, 0, 0, 0, 3, 0, 0, 0, 0, 0, 0, 2, 0, 0, 0, 1, 9, 27, 0, 0, 8, 0, 25, 1, 0, 0, 111, 1, 0, 0, 0, 0, 1, 1, 0, 3, 0, 0, 10, 0, 0, 0, 0, 0, 2, 1, 5, 44, 0, 0, 8, 0, 0, 0, 0, 36, 0, 8, 0, 0, 0, 0, 11, 125, 0, 2, 0, 0, 0, 0, 0, 0, 0, 0, 0, 1, 3, 2, 0, 3, 0, 5, 0, 0, 20, 0, 0, 6, 1, 0, 0, 13, 0, 0, 0, 0, 0, 0, 11, 0, 18, 1, 0, 0, 23, 0, 0, 0, 2, 0, 0, 3, 0, 0, 0, 29, 0, 0, 0, 0, 0, 0, 0, 1, 0, 9, 4, 0, 0, 0, 43, 0, 0, 0, 0, 0, 51, 0, 5, 0, 1, 5, 0, 0, 32, 0, 0, 0, 10, 13, 78, 0, 0, 8, 1, 5, 0, 1, 0, 0, 3, 1, 0, 0, 0, 0, 0, 0, 87, 12, 0, 0, 0, 0, 0, 98, 0, 2, 0, 1, 0, 10, 4, 0, 4, 4, 5, 81, 0, 0, 100, 64, 0, 0, 0, 0, 0, 0, 4, 11, 2, 0, 0, 0, 1, 0, 3, 0, 0, 8, 42, 0, 0, 0, 16, 0, 0, 118, 0, 6, 0, 0, 0, 0, 0, 1, 40, 0, 9, 37, 0, 0, 0, 0, 0, 5, 0, 1, 0, 0, 0, 0, 0, 0, 23, 0, 31, 0, 0, 0, 5, 0, 0, 0, 0, 2, 56, 0, 0, 0, 4, 0, 33, 0, 0, 1, 0, 59, 82, 0, 3, 0, 0, 2, 0, 9, 8, 0, 58, 0, 0, 11, 0, 16, 0, 99, 0, 0, 2, 0, 0, 0, 0, 14, 0, 0, 3, 38, 1, 0, 0, 0, 80, 0, 16, 0, 0, 0, 0, 0, 0, 0, 0, 0, 9, 44, 22, 0
The Arms-of-Krupp_-1587-1968-The-Rise-and-Fall-of-the-Industrial-Dynasty-that-Armed-Germany-at-War-b, 0, 0, 0, 179, 55, 0, 0, 0, 0, 141, 1, 50, 7, 0, 0, 1, 0, 0, 0, 0, 0, 0, 0, 8, 1, 1035, 0, 0, 4, 0, 0, 0, 3, 0, 0, 0, 0, 0, 139, 0, 50, 0, 710, 0, 0, 0, 0, 9, 0, 0, 0, 106, 0, 0, 0, 0, 0, 0, 0, 3, 110, 0, 4, 0, 23, 0, 0, 110, 0, 18, 0, 4, 236, 411, 2, 0, 0, 0, 34, 0, 0, 0, 0, 0, 0, 74, 0, 68, 0, 85, 0, 0, 14, 1, 0, 0, 0, 8, 16, 12, 15, 0, 0, 0, 0, 130, 0, 0, 18, 0, 0, 78, 0, 5, 0, 69, 0, 5, 18, 0, 39, 1, 10, 0, 123, 533, 0, 0, 2, 0, 3, 0, 0, 0, 0, 0, 16, 0, 0, 191, 0, 0, 0, 0, 3, 10, 130, 0, 1, 0, 0, 2, 0, 0, 27, 40, 23, 0, 112, 0, 0, 104, 0, 0, 0, 0, 40, 5, 31, 85, 310, 4, 0, 34, 1, 0, 15, 1, 58, 35, 0, 59, 0, 196, 0, 0, 0, 46, 0, 10, 0, 0, 107, 55, 45, 0, 0, 0, 25, 0, 1, 9, 3, 169, 3, 0, 15, 0, 30, 16, 40, 61, 13, 0, 31, 0, 0, 0, 0, 9, 0, 0, 0, 0, 102, 0, 0, 0, 1, 1, 0, 3, 0, 0, 0, 0, 9, 0, 6, 2, 0, 54, 14, 0, 1, 0, 0, 1, 0, 0, 113, 0, 2, 0, 72, 0, 163, 5, 0, 0, 0, 10, 11, 1, 0, 0, 5, 0, 0, 60, 9, 0, 47, 36, 22, 59, 3, 2, 54, 0, 80, 0, 0, 0, 49, 0, 0, 0, 10, 23, 1, 54, 19, 14, 0, 51, 1, 47, 26, 53, 4, 7, 1, 0, 0, 220, 85, 0, 0, 0, 19, 0, 0, 0, 0, 9, 0, 0, 0, 0, 15, 0, 0, 59, 0, 0, 0, 0, 68, 0, 0, 14, 0, 19, 19, 0, 0, 55, 0, 0, 6, 0, 0, 0, 0, 0, 78, 0, 0, 181, 2, 40, 9, 0, 41, 3, 0, 80, 0, 0, 55, 0, 58, 0, 0, 2, 32, 0, 10, 16, 0, 0, 0, 5, 0, 0, 68, 29, 16, 42, 0, 0, 61, 0, 2, 25, 10, 0, 28, 0, 27, 50, 0, 0, 0, 0, 165, 19, 0, 0, 0, 0, 0, 0, 0, 0, 0, 0, 0, 44, 4, 0, 0, 0, 3, 3, 1, 0, 0, 0, 0, 0, 12, 0, 0, 19, 0, 7, 61, 0, 506, 0, 0, 0, 1, 0, 0, 2, 49, 109, 0, 43, 0, 0, 217, 0, 6, 0, 0, 0, 0, 0, 1, 0, 2, 0, 214, 5, 2, 0, 0, 696, 0, 3, 78, 0, 152, 241, 0, 2, 0, 0, 26, 0, 0, 0, 0, 0, 1, 550, 0, 1, 11, 0, 0, 0, 102, 0, 9, 0, 0, 0, 0, 2, 0, 0, 0, 38, 90, 35, 0, 5, 0, 37, 0, 0, 0, 1, 0, 0, 0, 0, 3, 0, 124, 75, 0, 16, 0, 408, 0, 0, 56, 0, 0, 33, 0, 10, 0, 13, 21, 0, 1, 1, 0, 2, 10, 68, 0, 0, 71, 149, 0, 315, 4, 0, 0, 0, 0, 1, 0, 0, 39, 0, 0, 0, 4, 0, 0, 8, 0, 0, 0, 0, 0, 0, 0, 61, 1, 0, 60, 0, 0, 13, 0, 0, 1, 83, 0, 0, 20, 0, 0, 1, 0, 14, 0, 0, 1, 0, 0, 0, 33, 0, 0, 25, 0, 39, 0, 245, 0, 0, 1, 76, 0, 0, 0, 0, 135, 96, 50, 0, 87, 1, 128, 0, 0, 38, 87, 0, 0, 2, 18, 0, 179, 21, 0, 35, 31, 138, 0, 121, 0, 47, 0, 0, 46, 0, 0, 0, 1, 34, 0, 0, 60, 0, 106, 0, 0, 0, 17, 6, 74, 0, 3, 29, 1, 432, 0, 0, 0, 0, 28, 0, 39, 0, 375, 0, 11, 0, 0, 0, 2, 0, 7, 56, 0, 1, 0, 0, 0, 55, 2955, 0, 19, 3, 0, 0, 11, 41, 12, 76, 0, 0, 9, 8, 0, 0, 0, 2, 43, 1, 0, 0, 0, 0, 40, 74, 0, 0, 0, 68, 0, 0, 101, 0, 29, 0, 0, 0, 3, 0, 0, 0, 0, 95, 0, 9, 4, 8, 0, 0, 139, 149, 0, 0, 0, 0, 0, 0, 0, 0, 1, 0, 0, 13, 0, 0, 2, 48, 0, 18, 90, 0, 0, 0, 0, 0, 0, 0, 22, 1, 0, 0, 0, 0, 0, 0, 21, 0, 8, 0, 0, 68, 6, 23, 34, 0, 0, 30, 50, 14, 109, 26, 5, 189, 8, 0, 42, 16, 0, 0, 0, 19, 0, 0, 113, 0, 0, 0, 0, 0, 0, 0, 130, 1, 0, 85, 0, 0, 0, 15, 0, 57, 0, 0, 0, 0, 57, 0, 0, 0, 42, 0, 9, 0, 0, 14, 28, 0, 74, 0, 77, 2, 15, 0, 14, 0, 0, 56, 9, 0, 2, 0, 24, 0, 1, 24, 11, 27, 76, 0, 10, 0, 0, 0, 22, 2, 0, 0, 0, 41, 0, 0, 0, 1, 4, 0, 0, 0, 0, 20, 32, 26, 0, 0, 107, 22, 46, 84, 1, 50, 35, 3, 0, 4, 40, 0, 30, 194, 13, 0, 425, 82, 0, 79, 0, 64, 1, 0, 6, 25, 33, 0, 0, 15, 0, 0, 0, 0, 0, 0, 1, 213, 0, 0, 0, 0, 6, 0, 0, 2, 0, 1, 3, 53, 1, 14, 0, 18, 0, 0, 82, 0, 143, 0, 0, 2, 3, 0, 0, 3, 12, 0, 0, 4, 0, 0, 0, 0, 22, 0, 0, 0, 0, 0, 0, 98, 18, 0, 45, 2, 0, 46, 0, 36, 0, 2, 1, 0, 0, 5, 0, 0, 154, 0, 0, 0, 128, 0, 0, 0, 54, 0, 0, 2, 69, 0, 0, 244, 0, 0, 27, 113, 2, 34, 3, 0, 0, 0, 1, 0, 9, 0, 1, 28, 0, 110, 60, 1, 0, 0, 0, 42, 0, 41, 0, 6, 1, 0, 2, 2, 0, 382, 0, 0, 2, 4, 0, 107, 276, 0, 0, 0, 9, 10, 0, 0, 0, 0, 109, 0, 0, 0, 1, 2, 0, 0, 0, 0, 6, 0, 63, 1, 0, 23, 1, 1, 0, 9, 0, 1, 0, 1, 11, 20, 30, 38, 6, 0, 0, 0, 80, 103, 0, 0, 69, 0, 59, 0, 0, 0, 19, 0, 0, 5, 0, 0, 108, 0, 0, 0, 0, 0, 47, 0, 29, 0, 297, 14, 71, 0, 0, 7, 107, 24, 1, 0, 0, 5, 0, 88, 0, 173, 0, 0, 0, 21, 162, 0, 0, 0, 0, 0, 3, 10, 126, 0, 24, 21, 0, 11, 39, 15, 104, 27, 81, 1, 0, 0, 0, 0, 0, 82, 4, 15, 5, 0, 0, 0, 144, 0, 15, 43, 0, 0, 5, 5, 110, 0, 336, 0, 0, 0, 0, 1, 0, 0, 0, 0, 0, 0, 25, 21, 0, 0, 0, 0, 0, 0, 20, 47, 0, 1, 1, 0, 0, 0, 5, 0, 0, 18, 0, 8, 1, 0, 3, 119, 0, 0, 3, 0, 0, 27, 49, 12, 15, 62, 2, 0, 0, 0, 0, 0, 0, 26, 20, 4, 0, 0, 0, 49, 4, 0, 256, 6, 26, 2, 3, 0, 0, 0, 7, 6, 0, 120, 19, 0, 0, 0, 11, 7, 0, 0, 103, 29, 0, 0, 51, 2, 0, 6, 0, 0, 8, 0, 0, 0, 0, 16, 5, 10, 58, 0, 0, 0, 0, 0, 6, 0, 59, 0, 0, 0, 22, 25, 0, 0, 0, 0, 0, 745, 0, 1, 0, 0, 19, 0, 0, 0, 0, 1, 0, 0, 45, 12, 0, 0, 151, 6, 0, 0, 40, 0, 0, 1, 0, 39, 0, 3, 0, 0, 78, 0, 3, 255, 14, 0, 1, 1, 5, 0, 16, 0, 170, 1, 0, 1, 0, 0, 0, 0, 190, 0, 0, 0, 33, 2, 103, 59, 28, 0, 0, 0, 0, 1, 0, 0, 0, 10, 1, 0, 0, 2, 0, 0, 17, 0, 1, 1, 0, 37, 0, 2, 0, 85, 172, 27, 0, 0, 33, 71, 0, 0, 126, 18, 266, 0, 0, 1, 0, 0, 0, 0, 0, 35, 0, 74, 0, 18, 32, 0, 158, 7, 103, 0, 0, 16, 2, 168, 0, 259, 0, 74, 1, 36, 0, 34, 127, 0, 0, 0, 0, 0, 0, 2, 0, 981, 28, 0, 1, 17, 1, 0, 61, 80, 3, 41, 0, 0, 2, 150, 0, 278, 0, 0, 0, 180, 0, 24, 0, 14, 7, 0, 0, 0, 14, 0, 0, 0, 10, 117, 0, 0, 0, 129, 0, 65, 3, 25, 0, 0, 14, 0, 0, 0, 0, 9, 1, 0, 1, 0, 0, 0, 0, 6, 0, 10, 0, 642, 4, 83, 132, 0, 0, 4, 0, 0, 2, 0, 40, 5, 71, 1, 4, 0, 2, 0, 156, 3, 16, 0, 197, 0, 0, 1, 11, 0, 14, 0, 25, 0, 11, 0, 33, 0, 51, 0, 0, 0, 0, 0, 31, 2, 6, 0, 29, 0, 0, 94, 1, 5, 3, 13, 0, 74, 1, 0, 0, 0, 0, 0, 1, 0, 0, 0, 24, 0, 0, 0, 9, 31, 0, 5, 0, 9, 0, 68, 0, 0, 1, 0, 5, 0, 0, 59, 0, 0, 0, 0, 0, 14, 61, 35, 0, 100, 26, 1, 0, 107, 0, 0, 0, 18, 32, 90, 0, 0, 81, 39, 0, 1, 14, 0, 0, 28, 2, 0, 0, 0, 0, 0, 0, 0, 19, 0, 0, 0, 0, 0, 58, 5, 7, 0, 2, 0, 11, 1, 0, 18, 33, 15, 70, 0, 0, 53, 189, 0, 6, 0, 0, 0, 14, 58, 204, 2, 0, 0, 0, 15, 0, 0, 0, 0, 63, 84, 0, 0, 16, 37, 0, 1, 149, 4, 0, 127, 0, 0, 0, 0, 1, 64, 3, 79, 174, 3, 0, 0, 1, 3, 9, 0, 11, 0, 0, 6, 0, 0, 0, 125, 183, 85, 0, 0, 1, 16, 0, 0, 0, 0, 12, 175, 0, 0, 22, 51, 0, 2, 0, 0, 312, 0, 28, 109, 0, 127, 2, 5, 17, 0, 16, 13, 1, 3, 0, 0, 7, 0, 135, 0, 21, 0, 0, 5, 0, 0, 0, 0, 55, 0, 0, 22, 289, 0, 0, 0, 0, 207, 0, 51, 1, 0, 0, 0, 0, 0, 0, 3, 0, 8, 176, 195, 3
The Big-fella-the-rise-and-rise-of-BHP-Billiton-by-BHPB-Billiton-LNG-International_-Inc, 0, 0, 0, 15, 24, 0, 0, 0, 0, 53, 1, 8, 23, 0, 0, 0, 4, 0, 0, 97, 0, 0, 0, 6, 0, 0, 0, 0, 8, 0, 0, 0, 1, 0, 0, 0, 0, 43, 110, 0, 7, 0, 58, 0, 0, 0, 0, 65, 0, 0, 0, 157, 0, 0, 0, 0, 0, 0, 0, 0, 61, 2, 0, 0, 9, 0, 0, 65, 0, 11, 1, 0, 0, 0, 0, 0, 0, 0, 29, 0, 1, 0, 0, 0, 0, 40, 0, 4, 0, 72, 0, 0, 4, 0, 0, 0, 0, 1, 19, 6, 3, 0, 0, 0, 0, 0, 0, 0, 11, 0, 0, 41, 0, 0, 47, 14, 0, 2, 12, 0, 11, 1, 0, 0, 62, 170, 0, 0, 0, 0, 5, 0, 0, 0, 0, 0, 85, 0, 0, 10, 0, 5, 0, 0, 0, 15, 50, 0, 89, 0, 0, 0, 1, 46, 12, 46, 6, 0, 28, 8, 0, 22, 0, 0, 0, 0, 9, 2, 21, 77, 0, 3, 0, 45, 1, 0, 0, 1, 27, 139, 0, 28, 0, 52, 0, 0, 0, 10, 0, 2, 0, 0, 38, 3, 23, 0, 0, 0, 3, 57, 0, 0, 3, 89, 2, 0, 2, 0, 6, 6, 11, 33, 3, 1, 10, 0, 0, 0, 0, 4, 0, 6, 0, 0, 2, 0, 0, 46, 0, 0, 2, 0, 0, 2, 0, 0, 11, 0, 0, 0, 0, 50, 22, 2, 0, 0, 0, 2, 0, 0, 22, 0, 0, 0, 55, 0, 43, 4, 0, 0, 0, 4, 39, 0, 0, 0, 0, 0, 0, 29, 15, 0, 30, 62, 17, 27, 1, 0, 2, 0, 20, 0, 0, 0, 6, 0, 0, 0, 2, 19, 0, 28, 8, 5, 0, 57, 1, 25, 7, 19, 1, 25, 12, 0, 0, 92, 51, 0, 0, 0, 23, 0, 0, 0, 0, 28, 0, 8, 0, 0, 9, 0, 0, 29, 0, 0, 0, 0, 7, 82, 47, 31, 0, 34, 1, 0, 0, 0, 0, 0, 0, 0, 0, 0, 1, 0, 68, 3, 0, 49, 144, 24, 7, 0, 84, 0, 2, 245, 0, 0, 15, 0, 4, 0, 0, 0, 12, 0, 39, 2, 0, 0, 0, 77, 0, 0, 43, 9, 5, 27, 0, 0, 24, 0, 1, 15, 6, 2, 9, 0, 16, 19, 0, 0, 0, 0, 0, 4, 0, 0, 0, 0, 0, 0, 3, 0, 0, 0, 0, 34, 1, 20, 0, 0, 2, 1, 0, 0, 0, 0, 0, 0, 1, 0, 0, 19, 0, 0, 29, 0, 0, 1, 0, 4, 2, 0, 1, 1, 31, 2, 0, 62, 0, 4, 65, 0, 0, 0, 0, 0, 0, 0, 0, 0, 40, 0, 125, 17, 0, 8, 0, 349, 0, 0, 0, 0, 182, 0, 0, 0, 0, 0, 0, 0, 0, 0, 0, 0, 0, 29, 0, 13, 9, 0, 0, 0, 10, 0, 0, 0, 0, 0, 0, 0, 0, 0, 2, 3, 16, 4, 0, 1, 0, 4, 0, 0, 0, 0, 0, 0, 0, 2, 239, 2, 53, 67, 0, 25, 2, 0, 2, 0, 24, 0, 0, 98, 0, 3, 5, 16, 11, 0, 0, 2, 0, 2, 2, 12, 0, 0, 20, 10, 0, 8, 0, 0, 0, 0, 0, 2, 0, 0, 60, 3, 0, 0, 49, 0, 0, 12, 0, 0, 0, 0, 0, 0, 0, 9, 1, 0, 15, 6, 0, 4, 0, 0, 7, 55, 0, 0, 78, 0, 0, 0, 42, 3, 0, 0, 202, 0, 0, 0, 18, 0, 0, 12, 9, 46, 1, 34, 0, 0, 1, 54, 0, 0, 0, 0, 149, 125, 30, 0, 59, 0, 24, 0, 0, 11, 14, 0, 0, 3, 0, 0, 116, 1, 0, 35, 1, 6, 0, 38, 0, 9, 0, 0, 184, 0, 0, 51, 0, 43, 0, 0, 55, 0, 34, 0, 0, 38, 0, 0, 13, 0, 0, 2, 0, 23, 1, 0, 0, 0, 56, 0, 2, 0, 142, 425, 4, 1031, 3, 0, 0, 0, 16, 22, 1, 0, 41, 0, 0, 76, 0, 73, 20, 10, 18, 0, 12, 48, 0, 28, 0, 0, 14, 8, 0, 0, 0, 0, 14, 21, 0, 0, 0, 0, 100, 30, 0, 5, 0, 68, 0, 0, 18, 0, 18, 0, 0, 1, 0, 0, 0, 35, 0, 15, 0, 1, 16, 16, 0, 0, 34, 51, 51, 0, 0, 0, 24, 0, 0, 0, 0, 0, 0, 23, 0, 0, 5, 23, 0, 1, 14, 0, 0, 0, 1, 0, 0, 0, 32, 0, 0, 0, 0, 0, 27, 0, 23, 0, 0, 0, 0, 24, 2, 1, 33, 0, 0, 15, 34, 5, 0, 13, 3, 52, 82, 4, 25, 0, 0, 0, 0, 0, 0, 0, 155, 0, 0, 0, 0, 0, 0, 0, 0, 0, 0, 33, 0, 0, 0, 0, 1, 17, 0, 0, 0, 0, 21, 0, 0, 0, 48, 0, 7, 0, 0, 3, 7, 0, 89, 0, 10, 7, 0, 0, 0, 4, 0, 5, 4, 0, 1, 0, 20, 0, 2, 12, 26, 21, 66, 0, 8, 0, 0, 0, 48, 0, 0, 0, 7, 129, 0, 0, 0, 0, 3, 0, 0, 0, 0, 19, 9, 21, 0, 0, 2, 10, 1, 8, 3, 14, 45, 24, 0, 0, 2, 0, 1, 166, 9, 0, 11, 1, 0, 26, 0, 30, 0, 0, 0, 24, 11, 0, 0, 4, 0, 0, 0, 0, 0, 0, 0, 208, 0, 0, 3, 0, 3, 0, 0, 0, 0, 0, 5, 13, 0, 7, 0, 1, 0, 0, 11, 1, 53, 0, 0, 3, 6, 2, 0, 6, 34, 0, 0, 0, 0, 0, 0, 0, 14, 0, 0, 0, 6, 0, 0, 34, 10, 0, 23, 2, 0, 11, 0, 4, 0, 1, 1, 1, 0, 1, 0, 0, 31, 0, 0, 0, 41, 0, 0, 0, 45, 0, 0, 0, 63, 0, 0, 74, 0, 0, 23, 162, 0, 94, 1, 0, 0, 0, 0, 0, 0, 0, 1, 1, 0, 22, 29, 5, 0, 0, 2, 9, 0, 3, 0, 7, 26, 0, 9, 268, 0, 54, 0, 2, 0, 0, 0, 50, 14, 0, 50, 0, 7, 0, 0, 0, 3, 0, 49, 0, 0, 0, 6, 1, 0, 0, 0, 0, 4, 0, 22, 0, 0, 40, 4, 2, 0, 23, 0, 2, 1, 1, 4, 21, 2, 0, 3, 0, 0, 0, 28, 4, 0, 0, 56, 0, 17, 0, 0, 0, 2, 0, 0, 1, 0, 0, 21, 0, 0, 0, 0, 0, 80, 0, 7, 0, 1, 29, 124, 26, 0, 3, 39, 28, 50, 0, 0, 2, 0, 35, 0, 87, 1, 1, 4, 45, 30, 0, 0, 0, 0, 0, 3, 5, 41, 0, 12, 0, 0, 4, 9, 26, 5, 1, 241, 1, 0, 0, 0, 0, 0, 13, 53, 20, 0, 0, 0, 0, 0, 0, 1, 66, 0, 0, 3, 1, 29, 0, 0, 0, 0, 0, 0, 0, 0, 0, 0, 0, 0, 4, 5, 10, 0, 0, 1, 0, 0, 0, 4, 78, 0, 5, 0, 0, 0, 0, 0, 0, 0, 1, 0, 44, 32, 0, 34, 127, 0, 0, 1, 0, 0, 20, 0, 5, 8, 157, 0, 0, 0, 0, 0, 0, 0, 1, 12, 0, 0, 0, 0, 69, 110, 0, 47, 7, 21, 5, 0, 0, 0, 0, 8, 10, 0, 20, 4, 0, 0, 0, 5, 4, 0, 0, 28, 16, 0, 0, 3, 72, 0, 2, 0, 0, 3, 0, 0, 0, 0, 6, 3, 30, 41, 0, 0, 0, 0, 0, 9, 0, 10, 0, 0, 0, 10, 3, 0, 0, 0, 0, 0, 0, 0, 0, 0, 0, 191, 0, 0, 0, 0, 1, 0, 0, 4, 86, 0, 1, 728, 7, 0, 0, 35, 0, 5, 0, 0, 5, 0, 10, 0, 0, 60, 2, 0, 107, 7, 0, 3, 7, 1, 0, 1, 0, 24, 0, 0, 0, 0, 3, 0, 0, 78, 1, 0, 0, 18, 0, 14, 107, 21, 0, 0, 0, 0, 52, 3, 0, 0, 0, 1, 0, 0, 1, 0, 0, 0, 0, 1, 0, 0, 35, 0, 0, 0, 127, 18, 176, 10, 0, 48, 7, 0, 0, 39, 8, 0, 0, 0, 3, 0, 0, 0, 0, 0, 4, 0, 31, 0, 16, 16, 0, 2, 135, 0, 0, 0, 2, 0, 25, 0, 29, 0, 82, 74, 25, 2, 28, 70, 0, 8, 0, 0, 0, 0, 2, 0, 20, 77, 0, 0, 17, 20, 0, 45, 21, 34, 44, 68, 0, 0, 12, 0, 110, 0, 0, 0, 1, 0, 39, 0, 32, 5, 0, 269, 0, 13, 0, 0, 0, 49, 28, 1, 0, 0, 106, 0, 78, 3, 0, 0, 0, 2, 0, 0, 0, 0, 3, 0, 10, 1, 0, 0, 0, 4, 58, 0, 6, 0, 2, 0, 26, 14, 0, 0, 15, 0, 0, 1, 0, 7, 11, 21, 1, 0, 0, 8, 0, 213, 10, 13, 0, 0, 0, 0, 1, 12, 0, 0, 1, 16, 0, 16, 1, 7, 0, 14, 0, 0, 28, 0, 0, 19, 0, 5, 0, 10, 0, 0, 0, 13, 0, 0, 4, 0, 15, 0, 0, 0, 2, 0, 0, 0, 0, 0, 0, 29, 0, 0, 2, 13, 1, 0, 2, 76, 0, 0, 169, 1, 0, 5, 0, 1, 0, 0, 216, 0, 0, 0, 1, 0, 4, 7, 16, 0, 48, 11, 2, 0, 23, 0, 130, 0, 37, 1, 29, 0, 0, 9, 1, 0, 4, 17, 0, 0, 29, 0, 0, 54, 0, 0, 0, 0, 0, 52, 93, 1, 0, 0, 0, 23, 201, 3, 1, 3, 0, 23, 1, 0, 14, 0, 3, 47, 0, 0, 61, 97, 0, 16, 0, 0, 0, 278, 1, 21, 0, 1, 0, 76, 4, 0, 0, 0, 0, 28, 43, 0, 0, 1, 21, 0, 0, 76, 12, 26, 0, 0, 0, 0, 0, 2, 65, 0, 21, 41, 0, 0, 11, 0, 0, 48, 0, 32, 0, 0, 0, 0, 0, 0, 22, 0, 42, 1, 0, 0, 13, 0, 0, 0, 0, 7, 25, 0, 0, 26, 1, 0, 17, 0, 3, 0, 0, 118, 98, 0, 8, 32, 24, 4, 0, 1, 4, 0, 2, 0, 0, 2, 0, 80, 0, 9, 0, 0, 6, 0, 0, 0, 0, 11, 0, 0, 7, 99, 0, 0, 0, 10, 74, 0, 34, 0, 5, 0, 0, 0, 0, 0, 46, 5, 23, 88, 14, 2
The Capital-One-Story-by-Mary-Curran-Hackett, 0, 0, 0, 1, 24, 0, 0, 0, 0, 23, 20, 18, 0, 0, 0, 0, 4, 0, 0, 0, 0, 0, 0, 4, 0, 0, 0, 0, 3, 1, 0, 0, 0, 1, 2, 0, 0, 3, 14, 0, 4, 0, 10, 0, 0, 0, 0, 27, 0, 0, 0, 2, 0, 0, 0, 0, 0, 0, 0, 0, 23, 0, 0, 0, 36, 0, 0, 10, 0, 0, 0, 0, 0, 0, 0, 0, 2, 0, 6, 0, 0, 0, 0, 0, 0, 11, 0, 0, 0, 11, 0, 0, 2, 0, 0, 0, 0, 0, 0, 0, 0, 0, 0, 0, 0, 0, 0, 0, 1, 0, 0, 7, 0, 0, 0, 4, 0, 0, 0, 0, 0, 0, 0, 0, 1, 26, 0, 0, 0, 0, 0, 0, 0, 1, 0, 0, 0, 16, 0, 2, 0, 0, 0, 0, 0, 0, 15, 0, 0, 0, 0, 0, 96, 0, 4, 13, 4, 0, 4, 0, 0, 13, 0, 0, 0, 0, 5, 0, 1, 0, 0, 0, 0, 36, 1, 0, 0, 0, 0, 6, 0, 2, 0, 10, 0, 0, 0, 2, 0, 0, 0, 0, 4, 0, 203, 0, 0, 0, 6, 0, 0, 10, 0, 22, 0, 0, 1, 0, 0, 0, 12, 8, 2, 0, 0, 0, 0, 0, 0, 139, 0, 0, 0, 0, 0, 0, 0, 0, 0, 0, 0, 0, 0, 0, 0, 0, 13, 0, 0, 0, 0, 11, 0, 1, 0, 0, 0, 0, 0, 0, 22, 0, 0, 0, 9, 0, 7, 0, 0, 0, 0, 1, 2, 0, 0, 0, 0, 0, 0, 0, 3, 0, 13, 0, 8, 4, 1, 0, 1, 0, 0, 0, 0, 0, 1, 0, 0, 0, 0, 1, 0, 10, 0, 0, 0, 0, 0, 24, 0, 1, 0, 75, 1, 0, 0, 7, 9, 0, 0, 45, 4, 0, 0, 0, 1, 9, 0, 0, 0, 0, 6, 0, 0, 3, 0, 0, 0, 0, 6, 0, 0, 7, 0, 1, 1, 0, 0, 0, 0, 0, 0, 0, 0, 0, 0, 0, 16, 0, 0, 0, 0, 5, 0, 0, 7, 0, 0, 11, 0, 0, 6, 0, 0, 0, 0, 0, 1, 0, 14, 1, 0, 0, 0, 0, 0, 0, 28, 0, 0, 3, 0, 0, 0, 0, 0, 6, 0, 0, 0, 0, 3, 9, 0, 0, 0, 0, 0, 0, 0, 0, 0, 0, 0, 0, 0, 0, 0, 0, 0, 17, 17, 0, 0, 2, 0, 0, 0, 0, 0, 0, 0, 0, 2, 0, 0, 0, 0, 0, 26, 0, 0, 1, 0, 0, 0, 0, 0, 0, 20, 1, 0, 10, 0, 1, 25, 0, 0, 0, 0, 0, 0, 0, 0, 1, 2, 0, 9, 17, 0, 0, 0, 112, 0, 0, 2, 0, 6, 0, 0, 0, 0, 0, 0, 0, 0, 0, 0, 0, 0, 1, 0, 0, 2, 0, 0, 0, 0, 0, 0, 0, 0, 0, 0, 0, 0, 0, 5, 1, 2, 6, 0, 0, 0, 8, 0, 0, 0, 0, 0, 0, 0, 1, 0, 0, 23, 15, 10, 1, 0, 0, 0, 2, 2, 0, 0, 12, 0, 0, 0, 0, 3, 0, 0, 0, 0, 0, 0, 8, 0, 0, 1, 0, 0, 0, 1, 0, 0, 0, 0, 0, 0, 0, 3, 0, 0, 0, 15, 0, 0, 1, 6, 0, 0, 0, 0, 0, 0, 3, 0, 0, 11, 0, 0, 0, 0, 0, 0, 34, 0, 0, 0, 0, 0, 0, 0, 1, 0, 0, 1, 0, 1, 0, 9, 0, 0, 6, 0, 1, 0, 2, 0, 0, 1, 6, 0, 0, 0, 0, 0, 2, 15, 0, 2, 0, 23, 0, 0, 3, 0, 0, 0, 2, 0, 0, 8, 0, 0, 30, 0, 7, 0, 14, 0, 4, 0, 0, 15, 0, 0, 0, 0, 23, 0, 0, 0, 0, 37, 0, 0, 0, 0, 0, 1, 0, 1, 0, 0, 9, 0, 0, 0, 0, 19, 0, 0, 0, 0, 0, 0, 0, 0, 0, 0, 0, 0, 9, 0, 1, 0, 0, 0, 15, 0, 0, 22, 1, 0, 0, 0, 7, 0, 27, 0, 0, 0, 1, 0, 0, 0, 0, 157, 7, 0, 0, 0, 0, 19, 5, 0, 0, 0, 7, 0, 0, 11, 0, 45, 0, 0, 0, 0, 1, 0, 0, 0, 19, 1, 0, 0, 3, 0, 0, 3, 3, 0, 0, 0, 0, 0, 0, 0, 0, 0, 0, 0, 7, 0, 0, 0, 22, 0, 1, 2, 4, 0, 0, 0, 0, 0, 0, 4, 0, 0, 0, 0, 0, 0, 0, 34, 0, 0, 0, 0, 6, 0, 0, 6, 0, 0, 3, 7, 8, 0, 4, 0, 11, 0, 0, 3, 1, 0, 0, 0, 7, 0, 0, 53, 0, 0, 0, 0, 0, 0, 0, 0, 0, 0, 17, 0, 0, 0, 0, 0, 0, 0, 0, 0, 0, 2, 0, 0, 0, 0, 0, 0, 0, 0, 1, 4, 0, 7, 0, 1, 16, 0, 0, 0, 0, 0, 0, 0, 0, 0, 0, 0, 0, 3, 2, 42, 5, 4, 0, 0, 0, 0, 0, 8, 0, 0, 0, 0, 7, 0, 0, 0, 0, 2, 0, 0, 0, 0, 1, 2, 0, 0, 0, 0, 0, 0, 0, 0, 8, 2, 0, 0, 0, 1, 0, 0, 62, 5, 0, 0, 0, 0, 6, 0, 1, 0, 0, 0, 10, 8, 0, 0, 0, 0, 0, 1, 0, 0, 1, 0, 1, 0, 0, 0, 0, 0, 0, 0, 0, 0, 0, 0, 13, 0, 0, 0, 0, 0, 0, 3, 1, 39, 0, 0, 0, 0, 25, 0, 0, 34, 0, 0, 0, 0, 0, 0, 0, 0, 0, 0, 1, 2, 0, 0, 2, 1, 0, 19, 0, 0, 0, 0, 8, 0, 0, 0, 0, 0, 2, 0, 0, 0, 0, 0, 0, 387, 0, 0, 0, 2, 0, 0, 0, 40, 0, 0, 2, 0, 0, 0, 29, 0, 14, 0, 0, 0, 0, 0, 0, 0, 0, 0, 0, 0, 1, 7, 7, 0, 0, 0, 0, 3, 0, 0, 9, 7, 0, 0, 0, 0, 16, 0, 0, 0, 0, 0, 2, 0, 20, 0, 0, 2, 0, 0, 0, 7, 0, 21, 0, 0, 0, 0, 0, 0, 0, 0, 0, 0, 0, 53, 0, 0, 20, 0, 0, 0, 1, 0, 7, 0, 0, 0, 10, 1, 0, 0, 0, 0, 0, 21, 0, 0, 0, 21, 0, 10, 0, 0, 0, 19, 0, 0, 0, 0, 1, 3, 0, 0, 0, 0, 0, 72, 0, 4, 0, 0, 0, 70, 24, 0, 0, 9, 8, 1, 0, 0, 0, 0, 15, 0, 11, 0, 28, 0, 3, 6, 0, 0, 0, 0, 0, 0, 24, 11, 0, 0, 0, 0, 0, 15, 1, 2, 0, 8, 2, 0, 0, 0, 7, 0, 7, 18, 0, 0, 0, 0, 0, 0, 0, 4, 38, 0, 0, 15, 0, 1, 0, 0, 0, 0, 0, 0, 0, 0, 0, 0, 0, 0, 0, 0, 2, 1, 0, 1, 0, 0, 0, 0, 26, 0, 1, 0, 0, 0, 0, 0, 0, 0, 0, 0, 11, 0, 0, 12, 0, 0, 0, 0, 1, 0, 15, 0, 1, 36, 22, 0, 0, 0, 0, 0, 0, 0, 0, 0, 0, 0, 0, 0, 17, 3, 0, 7, 0, 8, 0, 4, 0, 0, 0, 1, 5, 0, 8, 0, 0, 0, 0, 12, 0, 0, 0, 0, 0, 0, 0, 0, 2, 0, 0, 0, 0, 1, 0, 0, 0, 0, 0, 0, 11, 67, 0, 0, 0, 0, 0, 0, 0, 15, 2, 0, 0, 2, 1, 0, 0, 0, 0, 0, 0, 0, 0, 0, 0, 0, 0, 0, 0, 0, 0, 0, 0, 0, 0, 0, 0, 151, 83, 0, 0, 15, 0, 0, 0, 0, 0, 0, 1, 0, 0, 197, 0, 0, 4, 40, 0, 0, 0, 0, 0, 0, 0, 4, 0, 0, 0, 0, 0, 0, 0, 22, 0, 0, 0, 17, 2, 2, 20, 4, 0, 0, 0, 0, 0, 3, 0, 0, 0, 0, 0, 0, 0, 0, 0, 0, 274, 0, 0, 0, 10, 0, 0, 3, 5, 7, 1, 0, 0, 32, 1, 0, 0, 17, 3, 0, 0, 0, 1, 0, 0, 0, 0, 0, 0, 0, 9, 0, 8, 2, 0, 0, 13, 0, 0, 0, 0, 2, 1, 0, 11, 0, 4, 0, 0, 0, 0, 38, 0, 0, 0, 0, 0, 0, 0, 0, 1, 16, 0, 0, 20, 0, 0, 11, 2, 5, 2, 0, 0, 0, 2, 0, 8, 0, 0, 0, 0, 0, 3, 0, 13, 0, 0, 0, 0, 1, 0, 0, 0, 40, 0, 6, 0, 0, 4, 0, 15, 0, 0, 0, 0, 0, 0, 0, 0, 0, 0, 3, 4, 1, 0, 0, 0, 0, 6, 0, 15, 0, 0, 2, 0, 0, 0, 0, 0, 0, 0, 0, 0, 4, 0, 0, 0, 0, 0, 0, 0, 121, 104, 0, 0, 0, 0, 0, 0, 135, 0, 0, 1, 0, 0, 1, 0, 0, 0, 0, 0, 0, 3, 0, 0, 29, 0, 1, 0, 2, 0, 0, 0, 0, 0, 0, 0, 0, 25, 0, 0, 0, 1, 0, 0, 0, 0, 0, 0, 0, 0, 0, 24, 0, 0, 0, 0, 0, 0, 0, 0, 0, 0, 6, 0, 0, 0, 0, 0, 0, 0, 0, 0, 0, 0, 0, 0, 0, 7, 6, 0, 0, 9, 0, 0, 0, 11, 9, 42, 0, 0, 0, 0, 0, 0, 0, 0, 0, 5, 0, 0, 0, 0, 0, 0, 0, 0, 5, 0, 30, 0, 0, 0, 13, 0, 2, 0, 0, 0, 3, 0, 0, 0, 0, 8, 35, 0, 0, 16, 13, 0, 0, 0, 0, 0, 2, 0, 1, 0, 0, 0, 0, 0, 0, 1, 1, 0, 3, 4, 0, 0, 0, 10, 0, 1, 16, 0, 12, 0, 0, 0, 0, 0, 0, 24, 0, 3, 10, 0, 0, 0, 0, 0, 1, 0, 6, 0, 0, 0, 0, 0, 0, 16, 0, 19, 0, 0, 0, 19, 0, 0, 0, 0, 10, 9, 0, 0, 10, 0, 0, 4, 0, 0, 0, 0, 10, 66, 0, 0, 0, 0, 0, 0, 0, 1, 0, 3, 0, 0, 0, 1, 8, 3, 2, 0, 0, 1, 0, 0, 0, 0, 8, 0, 0, 0, 22, 0, 0, 0, 8, 3, 0, 9, 0, 0, 0, 0, 0, 0, 0, 0, 0, 3, 6, 5, 0
The Difference-Between-God-and-Larry-Ellison-by-Mike-Wilson-_z-lib.org_, 0, 0, 0, 35, 99, 0, 0, 104, 0, 51, 0, 9, 2, 0, 0, 23, 0, 1, 0, 0, 0, 0, 0, 76, 9, 0, 0, 0, 0, 1, 0, 0, 0, 0, 0, 0, 0, 0, 31, 0, 10, 0, 18, 0, 0, 0, 0, 0, 0, 0, 0, 18, 0, 0, 0, 98, 0, 0, 0, 0, 48, 0, 0, 0, 15, 0, 0, 18, 0, 1, 0, 0, 0, 0, 1, 0, 1, 0, 16, 0, 0, 0, 47, 0, 0, 13, 0, 1, 0, 165, 0, 0, 104, 1, 0, 0, 0, 0, 5, 6, 0, 0, 0, 0, 0, 0, 0, 0, 4, 0, 0, 11, 0, 0, 0, 16, 0, 2, 3, 0, 0, 0, 2, 0, 7, 253, 0, 3, 0, 0, 1, 0, 0, 0, 0, 0, 321, 0, 0, 2, 0, 0, 0, 0, 9, 1, 34, 0, 0, 0, 0, 0, 0, 0, 62, 20, 6, 0, 60, 0, 0, 53, 0, 0, 1, 0, 4, 0, 3, 1, 0, 0, 0, 17, 4, 0, 2, 0, 36, 9, 0, 20, 0, 17, 0, 0, 0, 22, 0, 8, 0, 0, 4, 1, 24, 0, 0, 180, 17, 0, 0, 4, 0, 22, 6, 0, 1, 0, 1, 2, 5, 50, 34, 0, 4, 0, 1, 0, 56, 3, 0, 59, 0, 0, 25, 0, 0, 0, 2, 0, 1, 1, 0, 0, 0, 0, 18, 0, 22, 0, 0, 7, 9, 1, 0, 0, 0, 0, 4, 0, 37, 0, 0, 0, 149, 0, 34, 0, 0, 0, 0, 1, 39, 0, 0, 0, 8, 0, 0, 10, 3, 0, 14, 1, 20, 31, 13, 0, 0, 0, 13, 0, 0, 0, 53, 0, 0, 0, 0, 16, 0, 6, 30, 0, 0, 6, 0, 42, 1, 11, 0, 109, 1, 0, 59, 11, 38, 44, 0, 10, 12, 0, 1, 0, 182, 39, 0, 19, 0, 0, 4, 0, 0, 6, 0, 0, 0, 0, 62, 0, 0, 18, 0, 7, 0, 0, 0, 0, 0, 0, 2, 0, 0, 0, 0, 0, 39, 1, 0, 6, 0, 3, 0, 0, 63, 0, 0, 72, 0, 0, 18, 0, 2, 0, 0, 0, 14, 0, 12, 0, 0, 0, 20, 4, 0, 0, 2, 7, 1, 178, 0, 0, 20, 0, 0, 3, 0, 0, 10, 0, 3, 3, 0, 0, 0, 0, 0, 8, 0, 0, 0, 0, 0, 2, 0, 0, 0, 3, 0, 17, 6, 0, 0, 0, 1, 0, 0, 0, 0, 0, 1, 0, 4, 4, 0, 21, 0, 0, 147, 0, 0, 30, 0, 0, 0, 0, 29, 0, 60, 4, 0, 7, 0, 5, 108, 0, 0, 0, 0, 0, 0, 1, 1, 0, 125, 0, 31, 19, 0, 0, 0, 443, 0, 1, 9, 0, 56, 0, 0, 0, 0, 0, 0, 0, 0, 0, 0, 0, 2, 45, 0, 0, 0, 0, 0, 0, 5, 0, 5, 0, 0, 0, 0, 0, 0, 0, 0, 5, 9, 10, 0, 0, 0, 52, 0, 0, 0, 0, 0, 0, 0, 1, 3, 0, 30, 160, 0, 5, 0, 0, 0, 0, 5, 0, 0, 2, 0, 2, 0, 4, 3, 0, 0, 3, 0, 0, 7, 2, 0, 2, 12, 1, 0, 5, 0, 0, 0, 0, 0, 1, 0, 2, 3, 0, 0, 101, 49, 0, 2, 3, 29, 1, 0, 0, 0, 0, 0, 4, 0, 0, 80, 0, 0, 15, 0, 0, 1, 33, 1, 0, 0, 0, 0, 0, 128, 0, 0, 0, 5, 0, 0, 25, 4, 0, 0, 6, 0, 6, 0, 22, 0, 0, 0, 40, 0, 0, 0, 0, 4, 3, 12, 0, 17, 0, 5, 0, 0, 12, 1, 0, 0, 7, 0, 0, 80, 0, 0, 20, 0, 14, 0, 25, 0, 8, 0, 0, 42, 0, 0, 41, 0, 35, 0, 0, 0, 68, 45, 0, 0, 0, 0, 0, 54, 0, 1, 0, 0, 17, 0, 2, 0, 0, 10, 10, 0, 0, 14, 0, 0, 0, 0, 0, 0, 0, 0, 16, 1, 20, 0, 0, 0, 194, 0, 0, 59, 0, 0, 0, 5, 1, 0, 18, 0, 0, 0, 3, 10, 0, 0, 2, 215, 3, 0, 0, 0, 0, 16, 8, 77, 0, 0, 65, 0, 1864, 24, 0, 12, 0, 0, 0, 1, 1, 0, 0, 0, 37, 0, 0, 0, 1, 0, 0, 20, 2, 0, 0, 0, 0, 0, 0, 0, 0, 0, 0, 0, 5, 0, 0, 0, 70, 0, 7, 43, 0, 0, 0, 10, 0, 1, 0, 14, 3, 0, 0, 0, 0, 0, 0, 13, 0, 0, 0, 0, 52, 1, 0, 52, 0, 0, 3, 39, 1, 0, 6, 0, 28, 3, 0, 24, 0, 0, 0, 0, 49, 0, 0, 84, 0, 0, 0, 0, 0, 0, 0, 0, 0, 0, 27, 0, 0, 0, 7, 0, 1, 0, 0, 0, 0, 14, 0, 0, 0, 13, 0, 0, 0, 0, 3, 19, 0, 10, 0, 11, 8, 0, 0, 0, 0, 0, 0, 1, 0, 2, 0, 1, 1, 56, 10, 7, 34, 22, 0, 1, 0, 0, 0, 36, 0, 0, 0, 0, 7, 0, 0, 0, 0, 2, 0, 0, 0, 0, 15, 0, 1, 0, 0, 12, 4, 0, 2, 0, 9, 29, 0, 101, 0, 142, 0, 1, 470, 28, 0, 2, 2, 0, 42, 0, 39, 0, 0, 0, 22, 8, 0, 0, 6, 0, 0, 0, 0, 0, 1, 0, 24, 0, 0, 0, 0, 1, 0, 0, 0, 0, 0, 0, 6, 0, 0, 0, 0, 0, 0, 6, 0, 11, 102, 0, 0, 0, 2, 0, 0, 34, 0, 0, 2, 0, 0, 0, 0, 11, 0, 0, 2, 3, 0, 0, 159, 5, 0, 7, 1, 0, 3, 0, 32, 0, 2, 0, 0, 0, 3, 6, 0, 3, 0, 0, 0, 6, 0, 0, 0, 21, 0, 0, 0, 53, 0, 0, 38, 0, 0, 1, 95, 0, 30, 223, 0, 0, 0, 0, 0, 0, 0, 0, 0, 1, 11, 11, 2, 0, 0, 0, 38, 9, 5, 0, 6, 6, 0, 0, 1, 0, 53, 0, 0, 0, 3, 0, 32, 10, 0, 0, 58, 1, 0, 0, 0, 1, 0, 13, 0, 0, 0, 0, 0, 0, 1, 0, 0, 3, 0, 33, 0, 0, 61, 0, 0, 0, 5, 5, 3, 0, 4, 0, 9, 0, 0, 0, 0, 0, 0, 60, 0, 0, 0, 8, 1, 42, 0, 0, 0, 2, 0, 0, 0, 0, 2, 10, 0, 0, 0, 0, 0, 53, 0, 4, 0, 0, 5, 84, 48, 0, 0, 51, 36, 0, 0, 0, 0, 0, 15, 0, 77, 0, 0, 0, 14, 17, 0, 0, 0, 0, 0, 0, 7, 57, 0, 0, 6, 0, 0, 10, 0, 64, 0, 78, 71, 0, 0, 0, 30, 0, 76, 12, 28, 0, 0, 0, 0, 0, 0, 3, 41, 0, 0, 0, 0, 17, 0, 0, 0, 0, 0, 0, 0, 0, 0, 0, 0, 0, 0, 4, 11, 0, 0, 0, 0, 0, 0, 1, 39, 0, 1, 0, 0, 0, 0, 0, 0, 0, 1, 3, 19, 0, 0, 21, 2, 0, 0, 4, 1, 0, 13, 0, 3, 4, 138, 1, 0, 0, 0, 0, 0, 0, 0, 0, 0, 0, 0, 0, 41, 0, 0, 83, 1, 12, 2, 0, 0, 0, 0, 4, 16, 0, 12, 3, 0, 0, 0, 9, 1, 0, 0, 34, 1, 0, 0, 10, 3, 0, 1, 0, 0, 3, 0, 0, 0, 0, 0, 1, 6, 165, 0, 0, 8, 0, 0, 0, 0, 90, 3, 0, 0, 4, 12, 0, 0, 0, 0, 1, 2, 0, 0, 0, 0, 3, 1, 0, 0, 0, 0, 0, 0, 10, 0, 0, 0, 608, 64, 0, 0, 11, 0, 0, 0, 1, 4, 0, 4, 0, 0, 22, 0, 0, 177, 1, 0, 0, 0, 6, 0, 0, 0, 14, 0, 0, 0, 0, 17, 0, 0, 22, 1, 0, 0, 13, 4, 27, 90, 9, 0, 0, 0, 0, 6, 0, 0, 0, 3, 3, 0, 0, 0, 0, 0, 0, 0, 0, 0, 0, 3, 0, 0, 6, 81, 90, 11, 4, 1, 6, 8, 0, 0, 17, 6, 0, 0, 0, 2, 0, 0, 0, 0, 0, 17, 0, 5, 0, 14, 0, 0, 0, 23, 0, 0, 0, 3, 3, 11, 0, 43, 0, 8, 0, 0, 0, 4, 35, 3, 0, 0, 0, 0, 0, 0, 0, 0, 11, 0, 0, 6, 0, 0, 18, 3, 2, 61, 0, 0, 0, 6, 6, 85, 0, 1, 0, 0, 0, 1, 0, 1, 1, 0, 0, 0, 7, 1, 0, 0, 23, 6, 43, 0, 0, 22, 0, 24, 1, 0, 0, 0, 0, 0, 0, 0, 0, 0, 3, 0, 6, 0, 0, 0, 0, 3, 4, 16, 0, 0, 0, 2, 3, 0, 0, 0, 0, 0, 4, 0, 51, 1, 21, 0, 0, 0, 0, 0, 181, 8, 0, 0, 0, 0, 0, 0, 3, 0, 0, 0, 1, 2, 3, 0, 0, 0, 7, 0, 0, 2, 0, 0, 2, 0, 1, 0, 29, 0, 0, 0, 0, 0, 0, 0, 0, 29, 1, 0, 0, 0, 0, 0, 1, 0, 0, 0, 24, 0, 0, 0, 0, 6, 0, 1, 0, 0, 0, 0, 455, 0, 6, 8, 0, 0, 0, 19, 1, 0, 0, 1, 0, 12, 0, 3, 0, 3, 19, 1088, 0, 92, 0, 0, 2, 25, 28, 57, 0, 0, 0, 0, 2, 0, 0, 1, 0, 7, 1, 0, 0, 0, 0, 0, 0, 0, 40, 0, 252, 0, 0, 0, 54, 3, 4, 0, 1, 0, 3, 0, 0, 7, 17, 7, 164, 0, 0, 45, 22, 0, 0, 0, 0, 0, 0, 7, 12, 0, 0, 0, 0, 7, 0, 0, 0, 0, 19, 25, 0, 0, 0, 3, 3, 0, 69, 0, 48, 0, 0, 0, 0, 0, 0, 38, 1, 26, 46, 0, 0, 0, 0, 1, 6, 0, 4, 0, 0, 0, 0, 0, 0, 22, 0, 13, 0, 0, 0, 1, 0, 0, 0, 32, 49, 44, 0, 0, 8, 0, 0, 10, 0, 0, 0, 0, 37, 94, 0, 14, 0, 3, 19, 0, 0, 3, 0, 12, 0, 0, 0, 0, 23, 0, 10, 47, 0, 2, 0, 0, 0, 0, 7, 0, 0, 0, 25, 0, 0, 0, 0, 79, 0, 4, 0, 0, 0, 0, 1, 0, 0, 1, 0, 36, 44, 8, 1
The king-of-content-Sumner-Redstones-battle-for-Viacom_-CBS_-and-everlasting-control-of-his-media-em, 0, 0, 0, 26, 15, 0, 0, 0, 0, 47, 3, 10, 1, 0, 0, 0, 0, 0, 0, 0, 0, 0, 0, 93, 0, 0, 0, 0, 3, 2, 0, 0, 2, 1, 0, 0, 0, 0, 17, 0, 14, 0, 39, 0, 0, 0, 0, 16, 0, 0, 0, 31, 0, 0, 0, 0, 0, 0, 0, 0, 57, 0, 0, 0, 20, 0, 0, 30, 0, 6, 0, 0, 0, 0, 2, 114, 0, 0, 97, 0, 0, 0, 0, 0, 0, 31, 0, 1, 0, 90, 3, 0, 10, 0, 0, 0, 0, 0, 6, 4, 1, 1, 0, 0, 13, 0, 0, 0, 7, 0, 0, 11, 0, 0, 0, 16, 0, 29, 0, 0, 0, 0, 0, 0, 22, 169, 0, 0, 0, 0, 26, 0, 0, 0, 0, 0, 0, 0, 0, 1, 0, 0, 0, 0, 5, 4, 48, 0, 1, 0, 0, 0, 13, 0, 8, 18, 7, 0, 53, 7, 8, 25, 0, 0, 16, 0, 3, 6, 25, 1, 0, 2, 0, 17, 0, 0, 183, 0, 9, 54, 0, 24, 0, 26, 0, 0, 1, 44, 0, 53, 0, 6, 1, 0, 18, 0, 0, 0, 4, 0, 0, 3, 0, 51, 0, 0, 2, 0, 5, 1, 4, 21, 119, 0, 11, 0, 0, 0, 0, 9, 0, 3, 0, 0, 24, 0, 0, 0, 4, 0, 1, 1, 0, 0, 0, 0, 13, 0, 0, 0, 0, 10, 4, 1, 0, 0, 0, 0, 0, 0, 20, 0, 0, 0, 129, 0, 38, 0, 0, 0, 0, 0, 10, 16, 0, 0, 0, 0, 0, 20, 0, 0, 73, 3, 8, 41, 2, 1, 3, 0, 11, 0, 0, 0, 11, 0, 0, 0, 3, 3, 0, 14, 7, 0, 0, 1, 0, 16, 1, 21, 0, 14, 0, 0, 0, 44, 25, 0, 0, 40, 19, 0, 1, 0, 0, 13, 0, 11, 0, 1, 5, 0, 0, 4, 0, 0, 30, 0, 31, 0, 0, 6, 0, 18, 0, 0, 0, 0, 0, 0, 88, 0, 0, 0, 0, 0, 54, 0, 0, 3, 0, 5, 0, 0, 18, 0, 2, 147, 0, 0, 6, 0, 1, 0, 0, 0, 8, 0, 13, 0, 0, 0, 0, 1, 0, 0, 5, 14, 1, 43, 0, 0, 4, 17, 0, 12, 0, 0, 5, 0, 13, 2, 0, 0, 0, 0, 0, 0, 1, 0, 0, 0, 0, 0, 1, 1, 0, 3, 1, 84, 3, 0, 0, 5, 33, 0, 0, 0, 0, 0, 0, 0, 2, 0, 0, 15, 0, 0, 49, 0, 0, 5, 0, 0, 0, 0, 1, 2, 93, 7, 0, 17, 0, 5, 101, 0, 0, 0, 0, 0, 0, 3, 2, 0, 24, 0, 47, 15, 0, 0, 1, 295, 1, 7, 4, 0, 37, 0, 0, 0, 0, 0, 0, 0, 0, 0, 0, 0, 1, 47, 0, 0, 1, 0, 0, 0, 13, 0, 1, 0, 0, 0, 0, 1, 0, 0, 13, 11, 10, 11, 0, 0, 0, 38, 0, 0, 0, 1166, 0, 0, 0, 0, 0, 0, 29, 82, 0, 5, 0, 0, 0, 1, 24, 123, 0, 23, 0, 1, 0, 5, 25, 0, 0, 0, 0, 0, 0, 21, 0, 0, 17, 1, 0, 7, 0, 0, 1, 8, 0, 0, 0, 0, 7, 0, 0, 0, 45, 0, 0, 1, 8, 0, 0, 0, 0, 0, 0, 5, 0, 0, 22, 0, 0, 5, 0, 0, 2, 48, 1, 0, 0, 0, 0, 0, 27, 4, 0, 0, 4, 0, 0, 0, 5, 0, 0, 2, 0, 9, 0, 88, 0, 0, 0, 19, 0, 0, 0, 0, 4, 1, 24, 2, 85, 0, 3, 1, 0, 6, 20, 0, 0, 6, 1, 0, 69, 0, 0, 19, 2, 4, 0, 23, 0, 29, 0, 31, 66, 0, 0, 4, 0, 19, 0, 0, 1, 0, 64, 0, 0, 0, 1, 0, 120, 0, 0, 0, 0, 30, 0, 0, 0, 3, 7, 0, 4, 0, 2, 0, 5, 0, 0, 0, 0, 0, 2, 17, 1, 1, 0, 0, 0, 40, 0, 0, 39, 0, 0, 0, 18, 1, 0, 8, 43, 0, 2, 1, 0, 0, 0, 1, 5, 7, 0, 0, 0, 0, 32, 15, 0, 0, 0, 53, 0, 0, 30, 0, 5, 0, 0, 0, 1, 0, 4, 0, 0, 13, 0, 6, 0, 5, 0, 0, 24, 3, 0, 1, 0, 0, 0, 0, 0, 48, 0, 0, 0, 11, 1, 0, 1, 28, 0, 2, 22, 0, 0, 0, 1, 0, 0, 0, 15, 0, 0, 0, 0, 0, 0, 0, 21, 0, 1, 0, 0, 38, 1, 2, 18, 0, 0, 7, 0, 21, 0, 3, 1, 46, 2, 0, 9, 1, 0, 0, 0, 5, 0, 0, 90, 0, 1, 0, 0, 0, 237, 0, 0, 0, 0, 38, 0, 0, 0, 17, 0, 1, 1, 0, 0, 0, 12, 0, 0, 0, 15, 0, 0, 0, 0, 1, 5, 0, 29, 0, 8, 20, 1, 0, 0, 2, 0, 0, 0, 0, 0, 0, 0, 0, 3, 2, 24, 1, 4, 0, 1, 9, 0, 0, 29, 0, 0, 0, 0, 31, 0, 123, 0, 1, 5, 0, 2, 0, 0, 2, 0, 1, 37, 498, 25, 18, 2, 45, 0, 22, 9, 0, 0, 0, 7, 0, 1, 106, 15, 0, 4, 12, 0, 45, 1, 5, 2, 0, 32, 16, 8, 0, 0, 3, 0, 0, 1, 0, 0, 0, 0, 12, 0, 0, 0, 0, 4, 0, 0, 0, 0, 0, 0, 11, 1, 1, 0, 2, 0, 0, 5, 5, 193, 0, 0, 4, 1, 15, 0, 0, 21, 0, 0, 156, 0, 0, 0, 0, 3, 0, 0, 0, 4, 0, 0, 15, 0, 0, 13, 1, 0, 5, 0, 15, 0, 2, 0, 0, 0, 23, 0, 0, 4, 0, 0, 0, 9, 0, 0, 0, 7, 5, 5, 0, 23, 0, 0, 59, 0, 0, 0, 114, 0, 12, 8, 0, 8, 0, 1, 0, 0, 0, 0, 0, 1, 17, 10, 0, 0, 0, 0, 1, 8, 1, 0, 24, 4, 39, 0, 1, 0, 245, 0, 0, 0, 2, 0, 47, 4, 0, 0, 0, 1, 10, 0, 0, 1, 0, 19, 0, 0, 0, 2, 0, 0, 1, 0, 0, 1, 58, 44, 2, 0, 12, 0, 0, 0, 8, 0, 0, 0, 0, 0, 5, 1, 0, 0, 0, 0, 0, 29, 0, 52, 1, 12, 0, 23, 0, 0, 0, 3, 0, 0, 0, 0, 0, 35, 0, 0, 0, 0, 0, 30, 0, 6, 0, 1, 18, 37, 9, 0, 0, 34, 51, 0, 0, 30, 1, 0, 15, 0, 66, 0, 0, 0, 10, 62, 0, 0, 0, 0, 0, 2, 0, 43, 0, 0, 2, 0, 0, 12, 0, 8, 0, 127, 3, 0, 0, 0, 4, 0, 24, 36, 20, 2, 0, 0, 0, 0, 0, 3, 22, 1, 0, 3, 0, 25, 0, 1, 0, 0, 0, 0, 0, 0, 0, 0, 0, 0, 0, 4, 10, 0, 0, 2, 0, 0, 0, 0, 55, 0, 1, 3, 0, 0, 0, 0, 0, 0, 3, 1, 4, 0, 0, 51, 1, 0, 0, 197, 0, 0, 24, 0, 2, 12, 119, 0, 0, 0, 0, 0, 0, 0, 0, 0, 0, 0, 0, 0, 25, 35, 0, 61, 8, 30, 1, 0, 0, 0, 0, 0, 32, 0, 21, 5, 0, 0, 0, 10, 1, 0, 0, 23, 2, 0, 0, 0, 20, 0, 2, 0, 0, 1, 0, 0, 0, 1, 10, 1, 17, 12, 0, 0, 0, 0, 0, 0, 2, 50, 0, 0, 0, 8, 7, 0, 0, 0, 1, 0, 0, 0, 3, 0, 2, 2, 0, 0, 0, 0, 0, 0, 0, 32, 0, 0, 0, 334, 2, 0, 0, 16, 0, 0, 0, 124, 2, 0, 3, 0, 0, 19, 3, 0, 152, 0, 0, 0, 4, 1, 161, 9, 0, 47, 0, 0, 0, 0, 7, 0, 0, 36, 202, 0, 0, 17, 1, 19, 76, 15, 0, 0, 0, 0, 150, 0, 0, 0, 9, 0, 1, 0, 3, 0, 0, 2, 0, 0, 1, 0, 3, 0, 0, 0, 56, 83, 16, 0, 0, 14, 17, 0, 0, 12, 19, 0, 0, 0, 2, 0, 0, 0, 0, 0, 1, 0, 10, 0, 5, 5, 0, 0, 28, 0, 0, 0, 5, 0, 7, 0, 183, 0, 18, 0, 1, 0, 14, 69, 2, 0, 0, 0, 0, 0, 0, 0, 2, 18, 50, 0, 23, 0, 0, 3, 8, 28, 47, 0, 0, 3, 9, 0, 77, 0, 0, 0, 2, 0, 3, 0, 9, 0, 0, 0, 0, 10, 0, 0, 0, 21, 6, 24, 0, 0, 68, 0, 39, 2, 0, 0, 127, 0, 0, 0, 0, 155, 2, 0, 30, 5, 0, 0, 0, 1, 16, 0, 9, 0, 0, 0, 9, 17, 0, 0, 0, 0, 0, 0, 0, 47, 3, 3, 0, 0, 0, 2, 0, 206, 2, 3, 0, 0, 0, 0, 0, 7, 0, 0, 0, 5, 1, 0, 0, 0, 0, 6, 0, 0, 0, 2, 0, 5, 0, 6, 0, 13, 0, 0, 0, 1, 0, 0, 2, 0, 15, 2, 1, 0, 5, 0, 0, 0, 28, 0, 0, 11, 0, 0, 1, 0, 0, 0, 0, 0, 0, 0, 0, 2, 0, 3, 0, 0, 0, 0, 12, 1, 96, 0, 0, 0, 83, 0, 1, 0, 14, 35, 0, 0, 59, 0, 0, 0, 41, 7, 42, 2, 0, 0, 4, 0, 0, 1, 0, 0, 16, 7, 0, 0, 0, 0, 0, 0, 0, 25, 0, 0, 0, 0, 0, 25, 0, 8, 0, 0, 0, 6, 0, 0, 30, 6, 1, 75, 0, 0, 13, 21, 0, 0, 0, 0, 0, 0, 35, 7, 0, 0, 0, 0, 71, 0, 0, 3, 0, 16, 21, 2, 0, 0, 9, 0, 0, 63, 0, 30, 0, 0, 0, 0, 0, 1, 24, 1, 78, 31, 1, 2, 0, 0, 1, 2, 0, 11, 2, 0, 0, 0, 0, 3, 21, 0, 21, 0, 0, 0, 5, 0, 0, 0, 5, 0, 140, 0, 0, 11, 0, 0, 141, 51, 0, 1, 0, 13, 53, 3, 7, 0, 2, 4, 0, 5, 0, 0, 2, 0, 0, 0, 0, 26, 0, 8, 0, 0, 2, 0, 0, 0, 0, 11, 0, 0, 2, 40, 69, 0, 0, 1, 74, 0, 16, 0, 1, 0, 0, 0, 0, 2, 1, 0, 34, 40, 31, 2
The partnership-the-making-of-Goldman-Sachs-by-Goldman_-SachsCo.Ellis_-Charles, 0, 0, 0, 49, 53, 0, 0, 0, 0, 128, 0, 20, 4, 0, 0, 0, 218, 0, 0, 1, 0, 0, 0, 23, 0, 0, 0, 0, 5, 0, 0, 0, 0, 5, 1, 0, 0, 1, 154, 0, 20, 0, 60, 0, 0, 0, 0, 110, 0, 0, 0, 126, 0, 0, 0, 4, 0, 0, 0, 0, 204, 2, 0, 207, 55, 0, 0, 58, 4, 2, 0, 0, 0, 0, 5, 5, 0, 0, 108, 0, 0, 0, 0, 0, 0, 241, 0, 2, 0, 357, 1, 0, 1, 1, 77, 0, 0, 1, 2, 16, 48, 0, 0, 0, 0, 0, 0, 0, 311, 0, 0, 59, 0, 0, 0, 50, 0, 5, 1, 78, 0, 0, 0, 0, 20, 367, 2, 0, 0, 0, 48, 0, 0, 0, 0, 0, 1, 0, 0, 3, 0, 0, 0, 54, 2, 5, 102, 0, 0, 0, 0, 1, 1, 0, 27, 104, 5, 0, 89, 13, 0, 50, 0, 0, 23, 0, 3, 0, 37, 11, 2, 0, 3, 217, 7, 0, 1, 1, 35, 78, 0, 89, 0, 29, 0, 0, 0, 16, 0, 12, 0, 100, 1, 1, 77, 1, 0, 5, 13, 0, 1, 21, 0, 235, 0, 0, 3, 0, 35, 5, 164, 37, 7, 0, 6, 0, 0, 0, 0, 15, 0, 0, 0, 0, 21, 0, 0, 0, 1, 313, 27, 0, 0, 0, 0, 0, 11, 0, 0, 1, 0, 20, 41, 116, 0, 0, 0, 2, 2, 1, 136, 0, 0, 0, 390, 0, 87, 4, 0, 0, 0, 87, 43, 9, 0, 0, 2, 2, 0, 12, 40, 0, 37, 9, 221, 22, 0, 1, 1, 0, 31, 0, 0, 0, 10, 0, 0, 0, 7, 5, 0, 86, 1, 14, 3, 3, 0, 132, 0, 8, 2, 28, 2, 0, 0, 82, 74, 0, 0, 1, 74, 0, 0, 90, 4, 28, 0, 14, 0, 0, 40, 0, 0, 21, 2, 55, 0, 0, 56, 0, 0, 28, 0, 58, 3, 0, 0, 0, 0, 0, 0, 0, 0, 0, 0, 0, 228, 43, 0, 150, 0, 31, 1, 4, 143, 0, 0, 102, 0, 0, 20, 0, 39, 1, 0, 1, 11, 0, 13, 0, 0, 0, 1, 4, 0, 0, 27, 12, 0, 205, 0, 1, 42, 0, 0, 119, 2, 0, 14, 0, 202, 32, 0, 0, 0, 0, 0, 0, 0, 0, 0, 0, 0, 0, 0, 0, 0, 20, 0, 229, 27, 0, 0, 0, 36, 0, 0, 0, 0, 1, 0, 0, 1, 1, 0, 13, 0, 0, 117, 2, 0, 94, 0, 0, 1, 0, 0, 0, 77, 1, 4, 125, 0, 82, 54, 0, 0, 0, 0, 0, 0, 7, 4, 0, 119, 0, 64, 63, 0, 0, 0, 548, 0, 4, 55, 0, 22, 0, 0, 0, 0, 0, 0, 0, 0, 0, 0, 0, 0, 21, 0, 0, 34, 0, 0, 0, 18, 0, 1, 80, 0, 0, 0, 0, 0, 0, 0, 7, 12, 489, 0, 1, 0, 48, 0, 0, 0, 1, 0, 0, 0, 6, 1, 0, 257, 111, 0, 4, 0, 0, 144, 0, 10, 0, 0, 106, 0, 1, 0, 16, 35, 0, 0, 0, 0, 0, 5, 13, 0, 0, 55, 22, 0, 4, 5, 0, 1, 0, 0, 388, 0, 9, 23, 0, 0, 0, 159, 0, 0, 33, 5, 0, 0, 0, 0, 0, 0, 20, 0, 0, 158, 1, 0, 16, 0, 0, 22, 178, 0, 1, 1, 0, 0, 0, 228, 11, 0, 0, 5, 0, 0, 0, 20, 0, 0, 58, 0, 22, 0, 50, 0, 0, 0, 57, 0, 0, 0, 0, 3, 211, 76, 1, 238, 0, 33, 0, 0, 6, 19, 0, 0, 1, 0, 0, 132, 8, 137, 101, 0, 5, 2, 42, 0, 8, 5, 0, 318, 0, 0, 13, 0, 150, 0, 68, 4, 0, 83, 0, 0, 0, 1, 0, 66, 0, 2, 7, 0, 2039, 0, 0, 0, 0, 64, 0, 4, 0, 42, 0, 17, 0, 0, 0, 0, 0, 10, 97, 1904, 2, 0, 0, 290, 121, 7, 0, 99, 1, 18, 166, 57, 12, 0, 24, 0, 0, 1, 9, 0, 0, 0, 3, 103, 142, 0, 0, 0, 0, 117, 38, 0, 0, 0, 61, 0, 0, 100, 5, 108, 15, 0, 0, 5, 8, 0, 0, 0, 190, 0, 0, 5, 104, 0, 0, 42, 10, 0, 0, 0, 0, 0, 0, 0, 0, 0, 0, 0, 36, 5, 0, 0, 30, 0, 1, 192, 1, 0, 0, 38, 25, 0, 0, 47, 0, 0, 0, 2, 0, 0, 0, 352, 0, 1, 0, 0, 29, 3, 0, 206, 0, 0, 24, 0, 39, 0, 9, 0, 92, 14, 1, 68, 6, 0, 1, 0, 20, 26, 0, 105, 6, 0, 0, 0, 0, 0, 0, 0, 0, 0, 53, 0, 0, 0, 1, 0, 1, 0, 0, 0, 0, 12, 0, 0, 0, 6, 0, 5, 0, 0, 109, 74, 0, 346, 0, 29, 69, 0, 104, 5, 0, 2, 9, 0, 0, 2, 0, 7, 0, 0, 41, 152, 37, 24, 0, 3, 90, 0, 0, 18, 1, 0, 0, 2, 179, 0, 0, 0, 0, 7, 0, 10, 0, 0, 26, 28, 0, 0, 0, 7, 2, 3, 6, 180, 46, 16, 0, 0, 3, 2, 0, 0, 575, 138, 0, 28, 7, 44, 32, 0, 57, 2, 0, 5, 24, 18, 0, 7, 6, 0, 0, 0, 0, 0, 0, 0, 140, 0, 0, 0, 0, 5, 0, 0, 0, 100, 0, 1, 21, 3, 0, 0, 5, 0, 0, 4, 0, 44, 0, 0, 1, 2, 0, 0, 1, 57, 0, 0, 0, 0, 0, 0, 0, 5, 0, 0, 0, 4, 0, 0, 375, 2, 0, 30, 0, 0, 4, 0, 14, 0, 0, 0, 0, 0, 23, 0, 328, 39, 0, 0, 0, 371, 0, 0, 0, 51, 0, 0, 1, 106, 0, 0, 58, 3, 0, 0, 444, 0, 51, 3, 0, 0, 0, 11, 1, 0, 0, 0, 0, 0, 91, 26, 7, 0, 0, 0, 3, 2, 8, 0, 3, 13, 26, 0, 0, 56, 109, 0, 0, 0, 1, 0, 166, 18, 0, 0, 0, 7, 0, 0, 0, 23, 0, 76, 103, 0, 0, 1, 0, 1, 0, 0, 0, 2, 0, 205, 0, 0, 86, 2, 0, 0, 539, 0, 6, 0, 0, 0, 188, 1, 0, 0, 0, 0, 0, 170, 1, 0, 0, 178, 0, 28, 0, 0, 0, 10, 5, 0, 0, 0, 104, 125, 0, 0, 0, 0, 0, 170, 0, 19, 0, 1, 2, 765, 24, 0, 0, 102, 222, 2, 0, 0, 7, 0, 201, 60, 210, 2, 0, 0, 184, 67, 0, 0, 0, 0, 0, 5, 36, 162, 0, 0, 14, 1, 8, 67, 1, 9, 19, 128, 4, 0, 0, 0, 5, 0, 50, 283, 20, 0, 0, 0, 0, 0, 0, 21, 112, 7, 0, 2, 2, 22, 0, 0, 0, 0, 215, 0, 0, 0, 0, 0, 0, 0, 0, 6, 31, 1, 1, 66, 0, 0, 0, 1, 410, 0, 4, 0, 0, 0, 0, 0, 0, 0, 0, 0, 183, 0, 0, 133, 23, 2, 0, 49, 0, 0, 62, 0, 19, 8, 232, 0, 0, 0, 0, 0, 1, 0, 6, 2, 0, 0, 0, 1, 83, 100, 0, 71, 8, 51, 2, 125, 0, 0, 1, 1, 23, 0, 17, 3, 0, 0, 0, 14, 4, 0, 0, 27, 1, 0, 0, 6, 84, 0, 0, 14, 0, 6, 0, 0, 0, 19, 17, 2, 50, 94, 0, 0, 0, 0, 0, 0, 0, 49, 0, 0, 0, 34, 26, 0, 0, 0, 0, 0, 0, 0, 0, 0, 0, 36, 0, 0, 0, 0, 0, 0, 0, 27, 1, 0, 0, 510, 19, 0, 0, 66, 0, 3, 0, 0, 1, 3, 138, 0, 0, 350, 38, 0, 138, 3, 0, 1, 0, 1, 0, 41, 0, 108, 0, 240, 0, 64, 3, 0, 0, 131, 1, 0, 0, 50, 3, 14, 131, 39, 0, 0, 0, 90, 0, 0, 0, 0, 0, 3, 0, 0, 1, 0, 0, 0, 0, 0, 0, 0, 14, 0, 0, 1, 204, 18, 348, 0, 1, 17, 26, 0, 0, 168, 42, 0, 0, 0, 5, 0, 0, 0, 1, 0, 1, 0, 71, 0, 139, 3, 0, 0, 28, 0, 0, 0, 4, 0, 72, 0, 38, 0, 125, 0, 8, 0, 13, 134, 0, 0, 0, 0, 1, 0, 0, 0, 21, 632, 0, 0, 36, 0, 0, 121, 21, 1, 87, 0, 0, 43, 33, 0, 141, 0, 18, 0, 1, 1, 13, 0, 117, 1, 0, 0, 0, 30, 4, 0, 0, 168, 20, 13, 0, 0, 46, 0, 500, 0, 0, 0, 0, 3, 0, 0, 0, 0, 4, 2, 0, 0, 0, 0, 0, 31, 74, 0, 131, 0, 3, 0, 42, 7, 0, 0, 4, 0, 0, 0, 162, 29, 2, 0, 0, 1, 0, 2, 0, 1412, 2, 19, 0, 0, 0, 0, 63, 239, 0, 0, 0, 0, 4, 2, 3, 0, 0, 39, 0, 0, 0, 1, 0, 60, 0, 1, 0, 5, 0, 0, 0, 1, 0, 1, 1, 0, 130, 0, 0, 0, 37, 0, 0, 0, 0, 0, 0, 207, 0, 0, 11, 0, 8, 0, 1, 0, 6, 0, 0, 3, 0, 11, 0, 0, 0, 0, 9, 0, 0, 2, 0, 0, 0, 0, 6, 0, 35, 8, 1, 0, 97, 0, 0, 0, 836, 168, 99, 0, 759, 2, 1, 0, 0, 1, 0, 0, 280, 7, 0, 0, 0, 0, 0, 0, 0, 71, 0, 1, 0, 0, 0, 7, 0, 9, 0, 0, 0, 16, 0, 0, 42, 7, 29, 235, 0, 0, 142, 75, 0, 0, 1934, 0, 0, 2, 26, 14, 0, 0, 0, 0, 2, 0, 13, 6, 0, 205, 24, 0, 0, 0, 17, 0, 0, 90, 1, 61, 0, 0, 0, 0, 0, 0, 169, 0, 191, 89, 0, 0, 0, 0, 6, 4, 0, 150, 1, 0, 1, 2, 0, 0, 148, 1, 53, 0, 0, 0, 134, 0, 0, 0, 0, 8, 9, 0, 0, 18, 0, 0, 11, 0, 0, 2, 0, 15, 399, 0, 7, 0, 2, 1, 0, 6, 4, 0, 3, 0, 0, 4, 9, 36, 0, 5, 0, 0, 13, 8, 0, 0, 0, 82, 256, 0, 4, 111, 0, 0, 1, 7, 45, 0, 42, 0, 0, 0, 0, 0, 0, 0, 54, 0, 27, 155, 22, 3
The Rio Tinto Company An Economic History of a Leading International Mining Concern 1873 1954 by Charles Harvey (z-lib.org), 0, 68, 0, 60, 18, 0, 0, 0, 0, 55, 0, 4, 5, 0, 0, 0, 1, 0, 0, 0, 0, 0, 10, 7, 0, 0, 0, 0, 3, 0, 0, 0, 1, 0, 0, 0, 0, 0, 121, 0, 16, 0, 154, 0, 0, 0, 0, 9, 0, 73, 0, 93, 0, 0, 0, 1, 0, 0, 0, 0, 35, 43, 0, 0, 14, 0, 0, 77, 0, 11, 0, 0, 0, 0, 0, 0, 0, 0, 4, 0, 0, 0, 0, 0, 0, 1, 0, 0, 0, 50, 1, 0, 1, 4, 0, 0, 0, 80, 3, 0, 7, 0, 0, 0, 0, 0, 0, 0, 34, 0, 0, 34, 0, 0, 0, 52, 0, 1, 0, 0, 19, 0, 0, 0, 254, 34, 0, 0, 0, 0, 1, 0, 0, 0, 0, 0, 4, 0, 0, 18, 0, 1, 0, 0, 0, 18, 23, 0, 0, 0, 0, 0, 0, 0, 2, 11, 0, 0, 24, 11, 0, 18, 0, 76, 0, 0, 43, 1, 55, 31, 0, 1, 0, 41, 0, 0, 0, 1, 82, 54, 0, 32, 0, 77, 0, 0, 0, 0, 0, 19, 0, 0, 217, 17, 6, 2, 0, 0, 8, 0, 0, 0, 0, 115, 0, 0, 11, 0, 9, 20, 22, 40, 0, 1, 80, 0, 0, 0, 0, 0, 0, 0, 0, 0, 3, 0, 0, 0, 0, 0, 0, 0, 0, 0, 0, 0, 11, 0, 0, 1, 0, 13, 0, 0, 0, 0, 0, 1, 0, 0, 9, 0, 0, 0, 37, 0, 52, 0, 0, 37, 0, 11, 0, 0, 0, 0, 0, 0, 0, 29, 12, 0, 30, 36, 11, 1, 0, 0, 2, 0, 0, 0, 0, 0, 0, 1, 0, 0, 1, 0, 0, 39, 3, 0, 1, 5, 0, 46, 8, 59, 14, 17, 1, 0, 0, 61, 75, 0, 0, 0, 48, 0, 0, 1, 0, 77, 0, 0, 0, 0, 5, 0, 0, 20, 0, 0, 0, 0, 10, 0, 0, 4, 0, 6, 0, 0, 0, 0, 0, 124, 0, 0, 0, 0, 0, 0, 38, 0, 0, 149, 0, 32, 58, 0, 85, 0, 2, 170, 0, 0, 6, 0, 0, 0, 0, 0, 21, 0, 88, 0, 0, 0, 6, 0, 0, 0, 202, 1, 13, 153, 0, 0, 20, 0, 0, 9, 6, 0, 6, 0, 10, 26, 0, 0, 5, 0, 0, 0, 0, 0, 0, 0, 0, 0, 1, 0, 0, 0, 0, 10, 39, 0, 34, 0, 14, 0, 5, 0, 0, 0, 0, 0, 0, 0, 0, 6, 0, 0, 21, 0, 0, 0, 0, 4, 0, 0, 0, 0, 24, 2, 0, 5, 0, 0, 28, 0, 0, 4, 0, 0, 0, 0, 0, 0, 0, 0, 147, 0, 0, 0, 0, 164, 0, 0, 0, 0, 11, 0, 0, 0, 0, 2, 0, 0, 0, 0, 0, 0, 0, 4, 0, 0, 8, 0, 0, 0, 27, 0, 0, 0, 0, 0, 0, 0, 0, 0, 0, 25, 15, 0, 0, 0, 0, 6, 0, 0, 0, 0, 5, 0, 0, 0, 2, 0, 104, 8, 0, 10, 0, 0, 0, 0, 26, 0, 0, 94, 0, 2, 0, 10, 4, 0, 0, 0, 0, 0, 1, 40, 0, 0, 8, 14, 0, 0, 0, 1, 0, 4, 0, 3, 0, 5, 5, 0, 0, 0, 8, 0, 0, 42, 0, 0, 0, 0, 0, 0, 0, 6, 0, 0, 16, 0, 0, 0, 0, 0, 0, 18, 0, 1, 18, 0, 0, 0, 0, 5, 0, 0, 0, 0, 0, 3, 14, 0, 0, 4, 0, 103, 0, 3, 0, 0, 0, 86, 0, 0, 0, 0, 60, 94, 11, 0, 4, 0, 30, 0, 0, 78, 11, 0, 0, 37, 3, 0, 20, 318, 0, 33, 0, 14, 0, 50, 0, 0, 0, 0, 297, 2, 2, 0, 0, 31, 0, 0, 28, 0, 22, 0, 0, 0, 0, 0, 1, 4, 0, 1, 0, 271, 1, 0, 0, 0, 166, 0, 7, 0, 14, 0, 7, 0, 0, 0, 3, 0, 27, 73, 0, 0, 0, 0, 0, 5, 0, 0, 1, 10, 0, 0, 7, 1, 1, 20, 0, 0, 2, 19, 0, 0, 0, 0, 15, 4, 0, 0, 0, 0, 4, 52, 0, 14, 0, 9, 0, 0, 42, 0, 88, 0, 0, 0, 0, 0, 0, 39, 0, 66, 0, 0, 107, 25, 0, 0, 25, 51, 0, 0, 0, 0, 17, 0, 0, 0, 0, 1, 22, 9, 0, 0, 1, 0, 0, 1, 10, 0, 0, 0, 0, 0, 3, 0, 6, 0, 0, 1, 0, 0, 15, 0, 11, 0, 0, 0, 0, 6, 1, 2, 50, 0, 0, 7, 43, 1, 0, 2, 11, 53, 8, 0, 115, 72, 0, 0, 0, 2, 0, 0, 176, 0, 0, 0, 147, 0, 0, 0, 0, 0, 0, 7, 0, 47, 0, 0, 0, 0, 1, 0, 0, 0, 1, 0, 0, 0, 12, 0, 53, 0, 0, 31, 21, 0, 135, 0, 51, 13, 0, 0, 0, 0, 0, 3, 0, 57, 0, 0, 10, 0, 0, 6, 8, 33, 19, 0, 38, 0, 0, 0, 7, 0, 0, 0, 0, 30, 0, 0, 0, 0, 2, 0, 1, 0, 0, 3, 12, 11, 0, 0, 0, 1, 4, 3, 3, 34, 0, 25, 0, 38, 0, 0, 0, 10, 9, 0, 66, 0, 0, 4, 0, 0, 0, 0, 3, 18, 47, 0, 0, 2, 1, 0, 0, 0, 0, 0, 0, 177, 0, 0, 0, 0, 0, 0, 0, 0, 0, 0, 22, 23, 0, 25, 0, 1, 0, 0, 7, 3, 59, 0, 0, 0, 0, 0, 0, 0, 91, 0, 0, 0, 1, 0, 0, 0, 0, 0, 0, 0, 1, 0, 0, 3, 0, 0, 50, 12, 0, 12, 0, 11, 0, 0, 0, 72, 0, 0, 0, 0, 137, 0, 0, 0, 140, 0, 0, 0, 75, 0, 0, 9, 28, 0, 0, 67, 1, 0, 10, 149, 0, 128, 8, 0, 0, 0, 2, 0, 0, 0, 0, 0, 0, 5, 103, 1, 0, 0, 0, 63, 0, 0, 0, 0, 7, 0, 17, 1, 0, 14, 0, 0, 0, 0, 0, 26, 12, 0, 0, 1, 4, 0, 0, 0, 0, 0, 88, 0, 0, 0, 0, 1, 0, 0, 0, 0, 1, 0, 62, 0, 0, 51, 0, 1, 0, 41, 0, 0, 0, 1, 7, 50, 2, 0, 6, 0, 0, 0, 29, 0, 0, 0, 188, 0, 0, 0, 0, 0, 8, 0, 0, 0, 0, 3, 22, 0, 0, 0, 0, 0, 180, 0, 22, 0, 9, 0, 195, 40, 0, 0, 73, 5, 22, 0, 0, 0, 0, 10, 0, 24, 0, 0, 0, 32, 13, 0, 0, 0, 0, 0, 7, 20, 49, 0, 1, 0, 0, 1, 7, 4, 1, 11, 65, 2, 0, 0, 0, 0, 0, 6, 12, 12, 0, 0, 0, 0, 0, 0, 0, 47, 0, 0, 0, 2, 40, 0, 0, 0, 0, 0, 0, 0, 0, 0, 0, 0, 0, 0, 18, 27, 0, 0, 0, 0, 0, 0, 25, 66, 0, 15, 0, 0, 0, 0, 0, 3, 0, 0, 0, 34, 0, 0, 1, 20, 2, 0, 0, 0, 0, 53, 0, 59, 1, 20, 1, 0, 0, 0, 0, 0, 0, 9, 0, 0, 0, 27, 6, 142, 35, 0, 34, 0, 20, 1, 2, 0, 0, 0, 3, 3, 0, 4, 0, 0, 0, 0, 7, 2, 0, 0, 1, 16, 0, 0, 1, 0, 0, 0, 0, 0, 1, 0, 0, 0, 0, 4, 5, 0, 39, 0, 0, 0, 0, 0, 0, 0, 5, 0, 0, 0, 4, 7, 0, 0, 0, 0, 0, 0, 0, 0, 0, 2, 1, 0, 0, 0, 0, 1, 0, 0, 0, 83, 0, 0, 1281, 48, 0, 0, 57, 14, 6, 0, 0, 8, 0, 2, 0, 0, 40, 0, 0, 0, 0, 0, 0, 0, 0, 0, 3, 0, 8, 0, 0, 0, 0, 0, 0, 0, 125, 0, 0, 0, 18, 0, 0, 7, 10, 0, 0, 0, 0, 0, 0, 0, 0, 6, 0, 0, 0, 0, 1, 0, 1, 0, 3, 0, 0, 104, 0, 0, 0, 44, 3, 5, 0, 0, 29, 0, 0, 0, 26, 5, 27, 0, 0, 0, 0, 0, 0, 0, 0, 4, 0, 128, 0, 6, 7, 0, 0, 68, 0, 0, 4, 0, 0, 40, 0, 2, 0, 120, 1073, 9, 400, 19, 35, 2, 118, 0, 0, 0, 0, 0, 0, 76, 74, 0, 0, 17, 0, 0, 55, 50, 66, 3, 0, 0, 2, 6, 0, 58, 0, 12, 0, 4, 0, 3, 0, 8, 3, 0, 0, 0, 1, 0, 0, 0, 47, 47, 0, 0, 0, 2, 0, 137, 4, 0, 0, 0, 2, 64, 0, 49, 0, 291, 1, 0, 2, 0, 1, 0, 0, 2, 0, 1, 0, 0, 0, 49, 4, 0, 0, 1, 0, 0, 5, 0, 0, 0, 19, 0, 0, 0, 0, 0, 239, 22, 0, 2, 0, 0, 119, 0, 6, 0, 0, 0, 25, 0, 7, 0, 44, 0, 29, 0, 0, 0, 0, 0, 24, 0, 0, 0, 28, 1, 0, 0, 0, 7, 0, 1, 0, 19, 0, 0, 0, 9, 0, 0, 0, 0, 0, 0, 20, 0, 0, 0, 1, 33, 0, 0, 0, 2, 0, 202, 0, 0, 0, 0, 6, 0, 0, 61, 0, 0, 0, 0, 0, 2, 2, 76, 0, 103, 16, 0, 0, 10, 0, 0, 0, 15, 66, 21, 0, 0, 0, 3, 0, 0, 24, 0, 0, 29, 0, 0, 0, 0, 0, 0, 0, 0, 30, 0, 0, 0, 0, 0, 10, 520, 3, 0, 0, 0, 5, 0, 1, 15, 0, 2, 14, 0, 0, 193, 68, 0, 73, 0, 0, 0, 246, 0, 5, 0, 0, 0, 1, 0, 0, 0, 0, 0, 115, 108, 0, 5, 3, 4, 0, 1, 43, 6, 0, 0, 0, 0, 0, 0, 1, 119, 0, 0, 7, 0, 0, 1, 0, 0, 17, 0, 13, 0, 0, 1, 0, 0, 0, 73, 0, 23, 0, 0, 0, 6, 0, 0, 0, 0, 14, 6, 0, 0, 46, 40, 0, 4, 0, 0, 2, 0, 31, 112, 0, 11, 0, 37, 0, 0, 0, 0, 0, 3, 0, 0, 0, 0, 23, 0, 2, 0, 0, 5, 0, 0, 0, 0, 32, 0, 11, 5, 86, 0, 0, 0, 0, 23, 0, 143, 0, 21, 0, 0, 0, 0, 0, 8, 0, 2, 20, 51, 0
The Rio-Tinto-mine_-its-history-and-romance, 0, 0, 0, 16, 0, 0, 0, 0, 0, 10, 0, 0, 0, 13, 0, 0, 0, 0, 20, 0, 0, 1, 11, 0, 0, 0, 0, 0, 1, 0, 0, 0, 21, 0, 0, 0, 0, 0, 19, 0, 2, 0, 18, 0, 0, 0, 0, 1, 0, 0, 0, 5, 0, 0, 0, 0, 0, 0, 0, 0, 25, 16, 0, 0, 1, 0, 0, 1, 0, 15, 0, 0, 0, 0, 0, 0, 0, 0, 0, 0, 0, 0, 0, 0, 0, 0, 0, 0, 0, 25, 0, 0, 0, 0, 0, 0, 0, 0, 0, 0, 4, 0, 0, 0, 0, 0, 0, 0, 0, 0, 0, 17, 0, 0, 0, 19, 0, 0, 0, 0, 48, 0, 0, 0, 22, 92, 0, 0, 0, 0, 0, 0, 0, 0, 0, 0, 17, 0, 0, 3, 0, 6, 0, 0, 0, 1, 11, 0, 0, 0, 0, 0, 0, 0, 0, 2, 1, 2, 2, 0, 0, 7, 0, 0, 0, 0, 35, 0, 7, 5, 0, 0, 0, 3, 0, 0, 0, 0, 20, 0, 0, 14, 17, 34, 0, 0, 0, 3, 0, 0, 0, 0, 56, 4, 11, 0, 0, 0, 0, 0, 0, 0, 0, 30, 0, 0, 0, 0, 3, 0, 6, 23, 0, 0, 15, 0, 0, 0, 0, 0, 0, 0, 0, 0, 0, 0, 0, 0, 0, 0, 0, 0, 0, 0, 0, 0, 2, 0, 0, 0, 33, 47, 0, 0, 0, 0, 0, 0, 0, 0, 1, 0, 0, 0, 9, 0, 7, 0, 0, 0, 0, 2, 0, 0, 0, 0, 0, 0, 10, 12, 0, 0, 0, 51, 4, 0, 0, 1, 0, 0, 4, 0, 0, 0, 0, 0, 0, 0, 2, 2, 0, 2, 2, 0, 0, 20, 0, 11, 40, 26, 0, 0, 0, 12, 0, 62, 4, 0, 0, 0, 3, 0, 0, 0, 0, 0, 0, 0, 0, 0, 0, 0, 0, 4, 0, 0, 0, 0, 1, 0, 0, 12, 0, 0, 0, 0, 0, 0, 0, 6, 0, 0, 0, 0, 0, 0, 1, 0, 0, 2, 0, 7, 60, 0, 5, 3, 0, 4, 0, 0, 1, 0, 1, 0, 9, 0, 13, 0, 3, 0, 0, 0, 0, 0, 0, 0, 0, 0, 2, 20, 0, 0, 39, 0, 0, 0, 0, 0, 11, 0, 0, 8, 0, 0, 0, 0, 0, 0, 0, 0, 0, 0, 0, 0, 2, 0, 0, 0, 0, 0, 1, 0, 1, 0, 3, 0, 0, 0, 0, 0, 0, 31, 0, 0, 0, 9, 0, 0, 12, 0, 0, 0, 0, 21, 0, 0, 0, 0, 3, 1, 0, 0, 0, 0, 14, 0, 0, 58, 0, 0, 0, 0, 0, 0, 0, 0, 65, 1, 0, 0, 0, 91, 0, 0, 0, 0, 14, 0, 0, 0, 0, 14, 0, 0, 0, 0, 0, 0, 0, 7, 0, 0, 0, 0, 0, 0, 27, 0, 0, 0, 0, 0, 0, 0, 0, 0, 0, 2, 5, 0, 0, 0, 0, 8, 0, 0, 0, 0, 0, 0, 0, 0, 1, 0, 12, 0, 0, 3, 0, 0, 0, 0, 8, 0, 0, 48, 0, 34, 0, 52, 0, 0, 0, 0, 0, 1, 0, 1, 0, 0, 40, 1, 0, 0, 0, 0, 0, 0, 0, 0, 0, 0, 0, 0, 0, 0, 0, 0, 0, 11, 0, 0, 0, 0, 0, 0, 0, 4, 0, 0, 12, 0, 0, 1, 0, 0, 0, 9, 0, 0, 4, 0, 0, 0, 0, 0, 0, 0, 0, 0, 0, 0, 0, 0, 0, 6, 0, 18, 0, 7, 0, 0, 0, 12, 0, 0, 0, 0, 45, 1, 0, 0, 1, 0, 3, 0, 0, 40, 3, 0, 0, 0, 26, 0, 0, 80, 0, 7, 0, 12, 0, 59, 0, 0, 0, 0, 9, 0, 29, 0, 0, 2, 0, 0, 0, 0, 2, 0, 0, 0, 0, 0, 0, 0, 0, 2, 0, 1, 41, 0, 0, 0, 56, 0, 23, 0, 1, 0, 5, 0, 0, 0, 0, 0, 0, 7, 0, 0, 0, 0, 0, 0, 0, 0, 0, 1, 0, 0, 1, 0, 0, 3, 0, 0, 1, 3, 0, 0, 60, 0, 0, 0, 0, 0, 0, 0, 0, 7, 0, 0, 0, 2, 0, 0, 10, 0, 10, 0, 0, 0, 0, 0, 0, 17, 0, 31, 0, 2, 64, 1, 0, 0, 0, 8, 0, 0, 0, 0, 7, 0, 0, 0, 0, 19, 0, 16, 0, 0, 0, 0, 0, 5, 1, 0, 0, 0, 0, 0, 0, 0, 3, 0, 0, 10, 0, 0, 35, 0, 1, 0, 0, 0, 0, 1, 0, 0, 8, 0, 0, 3, 13, 0, 0, 0, 0, 26, 0, 0, 22, 14, 0, 0, 0, 0, 0, 0, 50, 0, 0, 0, 1, 0, 0, 0, 0, 0, 0, 16, 0, 0, 0, 0, 0, 0, 0, 0, 0, 0, 1, 0, 0, 0, 43, 0, 3, 0, 0, 0, 0, 0, 23, 0, 44, 1, 0, 0, 0, 0, 0, 3, 1, 0, 0, 0, 0, 0, 0, 0, 0, 1, 58, 0, 40, 0, 0, 0, 0, 0, 0, 1, 0, 7, 0, 0, 0, 0, 0, 0, 0, 0, 14, 19, 1, 1, 0, 0, 0, 1, 29, 0, 0, 7, 0, 50, 0, 30, 1, 0, 0, 35, 0, 0, 2, 0, 0, 4, 0, 2, 0, 0, 1, 17, 3, 0, 0, 8, 62, 0, 0, 0, 0, 0, 0, 62, 0, 0, 0, 0, 0, 0, 0, 0, 0, 0, 23, 0, 0, 44, 0, 0, 0, 0, 5, 0, 16, 0, 12, 0, 0, 0, 0, 0, 5, 0, 0, 0, 0, 0, 10, 0, 3, 0, 0, 0, 0, 0, 0, 0, 0, 0, 6, 9, 0, 0, 0, 8, 0, 0, 0, 0, 0, 0, 0, 0, 7, 0, 0, 0, 23, 0, 0, 0, 1, 0, 0, 20, 23, 0, 0, 24, 15, 0, 0, 32, 0, 61, 0, 0, 0, 0, 0, 1, 0, 0, 0, 0, 0, 5, 18, 2, 0, 0, 0, 15, 0, 34, 0, 0, 0, 0, 1, 0, 0, 2, 0, 0, 0, 0, 0, 1, 9, 0, 0, 0, 16, 0, 0, 0, 0, 0, 20, 0, 0, 16, 0, 0, 0, 0, 0, 0, 2, 0, 12, 0, 0, 2, 0, 0, 0, 0, 0, 0, 15, 0, 39, 3, 9, 0, 1, 0, 0, 0, 49, 2, 0, 0, 13, 0, 2, 0, 0, 0, 2, 0, 48, 0, 15, 0, 4, 0, 0, 0, 0, 0, 2, 0, 0, 0, 0, 1, 6, 0, 30, 0, 66, 0, 45, 0, 0, 0, 0, 5, 0, 14, 0, 0, 24, 1, 25, 0, 0, 0, 0, 0, 0, 0, 11, 0, 38, 0, 0, 0, 0, 8, 1, 0, 0, 0, 0, 0, 0, 0, 0, 2, 1, 0, 0, 26, 0, 0, 0, 0, 0, 8, 0, 0, 0, 0, 13, 0, 0, 0, 0, 0, 0, 0, 0, 0, 0, 0, 0, 0, 47, 13, 0, 0, 0, 0, 14, 0, 36, 4, 0, 0, 0, 0, 0, 0, 0, 44, 0, 0, 0, 5, 0, 9, 0, 1, 0, 0, 0, 0, 0, 1, 0, 41, 0, 8, 0, 0, 0, 0, 0, 0, 0, 0, 0, 0, 0, 19, 0, 51, 0, 0, 23, 0, 9, 0, 0, 11, 0, 0, 0, 1, 0, 2, 0, 0, 0, 0, 2, 0, 0, 0, 12, 7, 0, 0, 0, 0, 0, 2, 0, 0, 0, 0, 0, 0, 0, 1, 0, 0, 35, 0, 0, 0, 0, 0, 0, 0, 0, 0, 0, 0, 21, 0, 0, 0, 0, 0, 1, 0, 0, 0, 0, 34, 0, 0, 0, 0, 0, 0, 0, 0, 1, 112, 0, 0, 57, 5, 0, 0, 6, 0, 0, 0, 0, 2, 0, 0, 0, 0, 1, 0, 0, 1, 3, 0, 0, 1, 0, 0, 0, 0, 18, 0, 0, 0, 0, 0, 0, 0, 49, 0, 0, 0, 23, 0, 12, 9, 0, 0, 0, 0, 0, 0, 0, 0, 0, 0, 0, 0, 0, 0, 27, 0, 0, 0, 14, 0, 0, 1, 0, 0, 0, 4, 1, 3, 0, 0, 0, 4, 0, 0, 0, 10, 0, 0, 0, 0, 0, 0, 0, 0, 0, 7, 0, 0, 0, 0, 33, 0, 0, 25, 0, 9, 13, 2, 1, 10, 0, 1, 0, 1, 182, 40, 0, 15, 7, 0, 2, 0, 0, 0, 0, 7, 0, 5, 0, 0, 0, 0, 0, 0, 33, 84, 12, 0, 0, 0, 2, 6, 0, 21, 0, 0, 0, 0, 0, 39, 0, 0, 0, 0, 0, 0, 1, 0, 0, 0, 0, 13, 0, 0, 0, 3, 0, 0, 0, 0, 0, 0, 1, 25, 0, 0, 0, 2, 0, 0, 0, 0, 0, 0, 0, 0, 0, 2, 0, 0, 0, 2, 36, 0, 0, 2, 0, 0, 25, 4, 0, 0, 2, 0, 0, 0, 0, 0, 7, 0, 0, 0, 0, 0, 0, 25, 2, 0, 0, 0, 2, 0, 0, 0, 7, 0, 1, 0, 0, 0, 0, 0, 1, 0, 0, 0, 57, 0, 0, 0, 1, 20, 0, 9, 0, 5, 0, 0, 0, 1, 0, 0, 0, 0, 0, 0, 1, 0, 12, 0, 0, 0, 0, 0, 0, 0, 0, 19, 0, 12, 0, 0, 0, 0, 0, 22, 0, 0, 0, 0, 0, 0, 2, 2, 0, 2, 1, 0, 1, 2, 0, 0, 0, 9, 1, 17, 0, 0, 0, 44, 0, 0, 34, 0, 0, 4, 0, 0, 0, 0, 0, 0, 0, 0, 0, 0, 0, 0, 0, 0, 1, 147, 0, 1, 0, 0, 0, 0, 0, 7, 0, 0, 15, 0, 0, 41, 20, 0, 33, 0, 0, 0, 59, 0, 6, 0, 0, 0, 0, 0, 0, 0, 0, 0, 5, 40, 0, 0, 67, 0, 1, 9, 16, 3, 0, 0, 9, 0, 0, 0, 0, 47, 0, 4, 6, 0, 0, 1, 0, 0, 7, 0, 3, 0, 0, 0, 0, 21, 0, 7, 0, 1, 0, 0, 0, 6, 0, 0, 0, 0, 10, 0, 0, 0, 19, 0, 0, 1, 0, 0, 0, 0, 10, 9, 0, 1, 0, 2, 0, 0, 2, 0, 0, 3, 0, 0, 0, 0, 3, 0, 22, 0, 0, 0, 0, 0, 0, 0, 44, 0, 0, 0, 0, 0, 15, 0, 0, 11, 0, 74, 0, 32, 0, 0, 0, 0, 0, 0, 0, 0, 16, 91, 0
The-Everything-Store-Jeff-Bezos-and-the-Age-of-Amazon-by-Brad-Stone-_z-lib.org_, 0, 0, 0, 14, 247, 0, 0, 0, 0, 45, 1622, 28, 4, 0, 0, 0, 6, 0, 0, 0, 0, 0, 0, 30, 0, 0, 0, 0, 3, 1, 0, 0, 0, 1, 0, 0, 21, 1, 31, 0, 18, 0, 16, 0, 0, 0, 0, 33, 63, 0, 0, 21, 0, 0, 1, 0, 0, 0, 0, 0, 59, 0, 0, 0, 3, 0, 52, 34, 0, 3, 0, 0, 0, 0, 137, 2, 1, 0, 14, 0, 0, 0, 0, 0, 0, 34, 0, 1, 0, 142, 0, 1, 19, 0, 0, 0, 1, 0, 7, 5, 0, 0, 0, 0, 0, 0, 1, 0, 19, 0, 0, 12, 0, 0, 0, 18, 6, 2, 2, 0, 0, 0, 0, 0, 3, 184, 1, 0, 0, 0, 13, 0, 3, 0, 0, 0, 0, 0, 0, 3, 0, 0, 0, 0, 0, 39, 44, 0, 0, 0, 0, 0, 6, 0, 18, 31, 19, 0, 56, 2, 2, 40, 0, 0, 12, 0, 8, 0, 56, 0, 0, 2, 0, 34, 5, 0, 4, 0, 16, 9, 0, 41, 0, 27, 0, 0, 0, 11, 0, 7, 0, 1, 0, 2, 20, 0, 0, 8, 45, 0, 0, 0, 0, 53, 65, 0, 23, 0, 8, 15, 14, 19, 26, 0, 3, 0, 0, 0, 0, 20, 0, 0, 0, 0, 2, 0, 0, 0, 2, 0, 0, 0, 0, 0, 0, 0, 29, 0, 17, 0, 0, 14, 1, 23, 11, 0, 0, 0, 2, 0, 35, 0, 0, 0, 103, 0, 28, 0, 0, 0, 0, 12, 7, 7, 0, 0, 4, 0, 0, 7, 14, 0, 36, 4, 12, 37, 5, 0, 5, 0, 13, 0, 0, 0, 11, 1, 0, 0, 0, 8, 0, 10, 27, 0, 0, 14, 0, 26, 0, 19, 2, 85, 0, 0, 0, 28, 14, 0, 0, 72, 12, 0, 0, 0, 10, 27, 0, 18, 0, 0, 19, 0, 0, 3, 0, 0, 0, 0, 425, 0, 0, 8, 0, 0, 1, 0, 0, 0, 0, 0, 6, 0, 0, 0, 0, 0, 37, 0, 0, 10, 0, 3, 2, 0, 69, 0, 0, 54, 0, 0, 16, 0, 0, 0, 0, 0, 7, 11, 41, 3, 0, 0, 17, 5, 0, 0, 7, 5, 2, 148, 0, 0, 5, 5, 0, 18, 3, 1, 7, 0, 4, 8, 0, 0, 0, 0, 0, 0, 0, 0, 0, 0, 0, 2, 0, 0, 0, 1, 0, 56, 11, 0, 0, 69, 57, 0, 0, 0, 0, 0, 0, 0, 70, 2, 105, 12, 8, 0, 98, 0, 0, 30, 0, 0, 0, 0, 26, 1, 61, 4, 0, 25, 0, 7, 59, 0, 0, 0, 0, 0, 0, 0, 0, 16, 29, 3, 34, 18, 91, 0, 0, 388, 11, 0, 1, 0, 68, 0, 0, 0, 0, 0, 0, 0, 0, 0, 2, 0, 0, 9, 0, 0, 0, 0, 0, 0, 13, 0, 0, 0, 0, 0, 0, 0, 0, 0, 6, 3, 6, 2, 0, 0, 35, 22, 0, 0, 0, 0, 0, 0, 38, 2, 1, 0, 23, 52, 0, 3, 0, 0, 0, 2, 22, 0, 0, 35, 0, 0, 0, 3, 10, 0, 0, 0, 0, 0, 7, 10, 0, 0, 28, 0, 0, 3, 2, 0, 2, 0, 0, 2, 0, 0, 2, 0, 0, 0, 27, 0, 0, 8, 95, 0, 0, 12, 42, 0, 0, 11, 0, 0, 36, 0, 0, 1, 0, 0, 0, 66, 2, 0, 4, 0, 0, 0, 6, 6, 0, 0, 6, 0, 0, 0, 7, 0, 0, 5, 0, 35, 0, 29, 0, 0, 0, 51, 0, 0, 0, 0, 0, 3, 9, 1, 61, 0, 2, 0, 34, 14, 0, 0, 0, 4, 0, 0, 73, 1, 0, 38, 4, 12, 1, 30, 0, 12, 0, 0, 203, 0, 0, 21, 0, 20, 1, 0, 15, 0, 70, 0, 0, 0, 5, 0, 9, 0, 110, 4, 0, 70, 0, 0, 0, 0, 45, 0, 1, 0, 2, 0, 4, 0, 0, 0, 0, 0, 2, 35, 4, 0, 0, 0, 3, 114, 0, 0, 72, 2, 0, 1, 10, 1, 0, 38, 0, 0, 4, 2, 0, 0, 0, 1, 343, 9, 0, 0, 0, 0, 134, 13, 0, 0, 0, 40, 0, 2, 13, 0, 25, 0, 0, 0, 0, 100, 0, 0, 0, 15, 1, 2, 0, 16, 0, 0, 14, 1, 0, 0, 0, 0, 0, 0, 0, 0, 0, 0, 0, 9, 2, 0, 0, 53, 0, 2, 11, 0, 1, 0, 1, 1, 0, 0, 6, 0, 6, 0, 1, 0, 0, 0, 12, 0, 1, 0, 0, 12, 11, 2, 10, 0, 0, 9, 84, 4, 0, 1, 1, 44, 3, 0, 16, 3, 0, 0, 0, 72, 0, 0, 42, 0, 1, 0, 0, 0, 0, 0, 0, 1, 0, 26, 0, 7, 0, 56, 0, 0, 0, 0, 0, 0, 40, 0, 0, 0, 9, 0, 0, 0, 0, 16, 15, 0, 27, 0, 6, 8, 0, 0, 0, 2, 0, 0, 0, 0, 1, 0, 0, 0, 83, 8, 51, 23, 4, 0, 3, 0, 0, 0, 25, 0, 0, 0, 0, 5, 0, 0, 0, 0, 3, 0, 0, 0, 0, 92, 13, 0, 0, 1, 2, 7, 1, 0, 2, 7, 13, 0, 0, 0, 8, 0, 2, 104, 43, 0, 11, 0, 0, 19, 0, 11, 1, 0, 2, 3, 23, 2, 0, 2, 0, 0, 1, 2, 74, 3, 0, 11, 0, 0, 0, 0, 1, 0, 0, 0, 0, 0, 0, 17, 0, 1, 0, 0, 0, 1, 7, 2, 6, 0, 0, 0, 0, 87, 21, 0, 31, 0, 0, 0, 0, 0, 0, 0, 4, 0, 0, 0, 5, 0, 0, 73, 0, 0, 38, 4, 32, 15, 1, 125, 0, 0, 0, 0, 0, 6, 0, 0, 0, 0, 0, 0, 44, 0, 1, 0, 10, 0, 0, 0, 57, 0, 0, 45, 0, 0, 10, 30, 0, 35, 0, 0, 0, 0, 2, 0, 0, 0, 3, 0, 3, 19, 11, 2, 0, 0, 0, 23, 4, 4, 0, 24, 8, 8, 1, 0, 0, 57, 1, 5, 1, 0, 0, 52, 4, 49, 0, 0, 3, 0, 0, 0, 4, 0, 17, 0, 0, 0, 0, 0, 0, 11, 50, 0, 2, 0, 136, 0, 0, 23, 1, 0, 0, 9, 0, 5, 0, 0, 3, 8, 0, 0, 0, 0, 0, 0, 17, 0, 0, 0, 29, 0, 33, 0, 0, 0, 1, 0, 0, 0, 0, 1, 32, 0, 0, 0, 0, 0, 53, 0, 8, 0, 0, 5, 86, 37, 0, 0, 29, 30, 4, 0, 0, 0, 0, 23, 0, 103, 1, 0, 0, 29, 17, 0, 0, 0, 0, 0, 0, 0, 44, 0, 0, 0, 0, 2, 48, 6, 28, 3, 217, 23, 0, 0, 0, 7, 0, 20, 47, 7, 1, 0, 0, 0, 0, 0, 5, 54, 0, 1, 13, 0, 8, 0, 0, 1, 0, 0, 0, 1, 0, 0, 0, 1, 0, 0, 2, 5, 1, 0, 8, 0, 0, 66, 0, 32, 1, 26, 0, 1, 0, 0, 0, 0, 0, 0, 0, 19, 0, 0, 23, 0, 0, 0, 5, 4, 0, 10, 0, 4, 56, 69, 1, 0, 0, 0, 0, 0, 0, 0, 0, 0, 0, 0, 0, 51, 3, 0, 61, 1, 8, 1, 0, 0, 0, 0, 6, 10, 0, 17, 2, 0, 0, 0, 50, 1, 0, 0, 13, 1, 0, 0, 2, 0, 0, 0, 0, 0, 2, 0, 0, 0, 5, 2, 0, 19, 202, 0, 2, 7, 0, 0, 2, 0, 43, 0, 0, 0, 3, 4, 1151, 0, 0, 0, 2, 0, 0, 0, 0, 0, 1, 0, 0, 0, 0, 1, 0, 0, 6, 0, 0, 0, 652, 23, 0, 0, 25, 0, 1, 0, 1, 3, 3, 8, 0, 0, 17, 4, 0, 113, 12, 0, 3, 4, 4, 0, 4, 0, 37, 0, 0, 0, 0, 1, 0, 0, 37, 0, 0, 0, 70, 6, 22, 159, 76, 0, 0, 1, 0, 0, 0, 0, 0, 0, 23, 1, 0, 2, 0, 1, 3, 0, 0, 0, 0, 6, 0, 0, 20, 120, 6, 25, 4, 1, 17, 6, 0, 0, 18, 17, 1, 0, 0, 71, 0, 0, 0, 0, 0, 3, 0, 5, 0, 2, 1, 0, 0, 17, 0, 0, 0, 4, 0, 13, 0, 35, 0, 8, 0, 1, 0, 3, 70, 0, 0, 0, 0, 0, 0, 0, 1, 7, 38, 0, 0, 35, 0, 0, 17, 4, 11, 31, 0, 0, 54, 24, 0, 118, 0, 4, 0, 1, 2, 3, 0, 11, 0, 0, 0, 0, 12, 1, 0, 0, 24, 8, 12, 0, 0, 26, 0, 27, 0, 0, 0, 0, 2, 0, 0, 0, 0, 4, 8, 0, 5, 0, 0, 0, 0, 11, 6, 19, 0, 3, 1, 17, 5, 1, 0, 7, 0, 0, 0, 0, 30, 4, 35, 0, 0, 0, 0, 0, 229, 19, 2, 0, 0, 0, 0, 0, 0, 0, 0, 1, 1, 1, 17, 0, 0, 0, 1, 0, 0, 2, 0, 0, 16, 0, 3, 0, 10, 0, 0, 0, 2, 1, 0, 1, 0, 21, 3, 4, 0, 40, 0, 0, 64, 0, 0, 0, 2, 0, 0, 4, 0, 23, 0, 0, 0, 0, 0, 0, 12, 0, 11, 0, 0, 0, 2, 25, 0, 0, 0, 4, 0, 5, 0, 1, 0, 8, 6, 2, 1, 45, 13, 0, 0, 32, 14, 88, 2, 0, 0, 0, 0, 0, 0, 0, 0, 20, 2, 0, 0, 0, 0, 0, 0, 0, 25, 0, 50, 0, 0, 0, 28, 0, 4, 0, 1, 0, 0, 0, 0, 2, 1, 1, 47, 0, 0, 63, 45, 0, 0, 4, 0, 0, 2, 0, 4, 2, 0, 0, 0, 3, 0, 0, 0, 0, 27, 21, 0, 0, 0, 25, 2, 0, 69, 0, 43, 0, 0, 0, 0, 0, 0, 68, 1, 57, 52, 4, 0, 0, 0, 1, 0, 0, 5, 1, 0, 0, 6, 0, 0, 15, 0, 34, 0, 0, 0, 0, 0, 0, 0, 5, 15, 37, 3, 0, 15, 1, 0, 47, 0, 0, 0, 0, 67, 64, 1, 1, 0, 2, 4, 0, 3, 1, 0, 3, 0, 0, 3, 3, 44, 99, 11, 0, 0, 1, 0, 0, 26, 2, 10, 0, 0, 5, 21, 0, 0, 0, 2, 45, 0, 21, 0, 0, 0, 0, 0, 0, 0, 3, 0, 38, 50, 12, 1
The-Google-Guys-Inside-the-Brilliant-Minds-of-Google-Founders-Larry-Page-and-Sergey-Brin-by-Richard-, 0, 0, 0, 11, 56, 0, 0, 0, 0, 21, 5, 6, 0, 0, 17, 0, 4, 0, 0, 0, 0, 0, 0, 31, 0, 0, 0, 0, 1, 13, 0, 0, 0, 0, 0, 1, 0, 0, 51, 0, 4, 0, 7, 0, 0, 0, 0, 4, 2, 0, 0, 5, 0, 0, 0, 0, 0, 0, 0, 0, 54, 0, 1, 0, 2, 4, 0, 17, 0, 0, 0, 0, 0, 0, 33, 0, 3, 0, 18, 0, 0, 0, 0, 0, 0, 24, 0, 16, 0, 25, 0, 0, 16, 0, 0, 0, 0, 0, 0, 2, 0, 0, 0, 0, 0, 0, 1, 0, 0, 0, 4, 6, 0, 0, 0, 5, 20, 1, 0, 0, 0, 0, 0, 0, 0, 65, 1, 0, 0, 0, 2, 0, 3, 0, 0, 0, 0, 0, 0, 1, 0, 0, 0, 0, 0, 1, 26, 0, 0, 0, 0, 0, 0, 0, 2, 1, 88, 0, 31, 2, 44, 15, 0, 0, 2, 0, 8, 1, 2, 0, 0, 0, 0, 14, 0, 0, 1, 0, 4, 2, 0, 15, 0, 4, 0, 0, 0, 9, 0, 4, 0, 0, 1, 0, 3, 0, 0, 4, 17, 0, 0, 0, 0, 29, 0, 0, 2, 0, 2, 0, 25, 5, 4, 0, 9, 0, 0, 0, 0, 5, 0, 0, 0, 0, 0, 0, 0, 0, 0, 0, 0, 1, 0, 0, 0, 0, 7, 0, 7, 0, 0, 1, 1, 57, 0, 0, 0, 0, 0, 0, 27, 0, 0, 0, 57, 0, 11, 0, 0, 0, 0, 4, 9, 1, 0, 0, 0, 0, 0, 3, 13, 0, 6, 0, 6, 12, 1, 0, 0, 0, 1, 0, 0, 0, 0, 0, 0, 0, 0, 7, 0, 3, 21, 0, 0, 0, 0, 19, 0, 3, 0, 87, 0, 0, 0, 30, 13, 0, 0, 16, 13, 0, 0, 0, 7, 21, 0, 0, 0, 0, 12, 0, 0, 3, 0, 0, 0, 0, 85, 0, 0, 11, 0, 1, 1, 11, 0, 0, 0, 0, 0, 0, 0, 0, 0, 0, 39, 4, 0, 0, 0, 3, 0, 0, 12, 0, 0, 24, 0, 0, 9, 0, 0, 1, 0, 0, 2, 0, 26, 0, 0, 0, 17, 5, 0, 0, 7, 15, 0, 10, 0, 0, 4, 0, 0, 1, 4, 0, 0, 0, 2, 8, 0, 0, 0, 0, 0, 1, 0, 0, 0, 0, 0, 0, 0, 0, 0, 1, 0, 15, 10, 0, 0, 871, 2, 0, 0, 0, 0, 0, 0, 0, 1, 0, 0, 0, 0, 0, 78, 0, 0, 8, 0, 0, 0, 0, 21, 0, 18, 0, 0, 13, 0, 1, 23, 0, 0, 0, 0, 0, 0, 0, 0, 0, 9, 0, 25, 23, 0, 0, 0, 139, 69, 1, 2, 0, 8, 0, 0, 0, 0, 0, 0, 0, 0, 0, 0, 0, 1, 4, 0, 0, 0, 0, 0, 0, 10, 0, 3, 0, 0, 0, 0, 0, 0, 0, 3, 0, 5, 2, 0, 0, 0, 7, 0, 0, 0, 0, 0, 0, 0, 1, 1, 0, 15, 35, 0, 1, 0, 0, 0, 0, 19, 0, 0, 4, 0, 0, 0, 1, 3, 0, 0, 0, 0, 0, 1, 5, 0, 0, 0, 0, 0, 1, 0, 0, 0, 0, 0, 0, 0, 1, 2, 0, 0, 0, 33, 0, 0, 3, 150, 0, 0, 0, 0, 0, 0, 11, 0, 0, 11, 0, 0, 1, 0, 0, 0, 40, 0, 0, 3, 0, 0, 0, 0, 0, 0, 0, 4, 0, 0, 0, 4, 0, 0, 3, 0, 5, 0, 6, 0, 0, 0, 31, 0, 0, 0, 0, 1, 0, 3, 1, 25, 0, 2, 0, 0, 13, 0, 0, 0, 6, 0, 0, 13, 1, 0, 20, 0, 4, 0, 5, 0, 3, 0, 0, 37, 0, 0, 5, 0, 12, 0, 0, 12, 0, 32, 0, 0, 0, 97, 0, 6, 0, 0, 0, 0, 15, 0, 0, 0, 0, 22, 0, 0, 1, 2, 0, 1, 0, 1, 0, 0, 0, 1, 12, 4, 0, 0, 0, 0, 43, 0, 0, 42, 0, 0, 0, 17, 0, 0, 37, 0, 0, 4, 4, 0, 0, 0, 0, 16, 1, 0, 0, 0, 0, 26, 19, 0, 0, 0, 12, 0, 0, 8, 0, 4, 0, 0, 0, 0, 1, 0, 0, 0, 6, 22, 0, 0, 1, 0, 0, 3, 3, 0, 0, 0, 0, 0, 0, 0, 0, 0, 0, 0, 3, 0, 0, 0, 59, 0, 0, 18, 0, 0, 0, 0, 0, 0, 0, 2, 0, 0, 0, 0, 0, 0, 0, 2, 0, 0, 0, 0, 12, 2, 0, 24, 0, 0, 11, 33, 1, 0, 1, 0, 30, 47, 0, 14, 0, 0, 0, 0, 25, 0, 0, 29, 0, 1, 0, 0, 0, 0, 0, 0, 0, 0, 13, 0, 0, 0, 5, 0, 1, 0, 0, 0, 0, 8, 8, 0, 0, 10, 0, 0, 0, 0, 3, 8, 0, 14, 0, 4, 4, 0, 0, 0, 1, 0, 0, 0, 0, 0, 0, 2, 0, 10, 3, 29, 13, 8, 0, 2, 0, 0, 0, 44, 0, 0, 0, 0, 1, 0, 0, 0, 0, 3, 0, 0, 0, 0, 227, 0, 0, 0, 2, 0, 3, 0, 1, 2, 16, 5, 0, 0, 0, 17, 0, 0, 210, 28, 0, 1, 3, 0, 7, 0, 1, 0, 0, 1, 9, 16, 0, 0, 0, 0, 0, 0, 0, 0, 0, 0, 38, 0, 0, 0, 0, 1, 0, 0, 0, 0, 0, 0, 2, 0, 0, 0, 0, 0, 0, 3, 35, 6, 0, 0, 0, 1, 69, 0, 0, 6, 0, 0, 0, 0, 0, 0, 0, 0, 0, 0, 0, 7, 0, 0, 23, 2, 0, 5, 0, 0, 1, 3, 10, 0, 1, 0, 0, 0, 3, 0, 0, 4, 0, 0, 0, 13, 0, 2, 0, 10, 0, 0, 0, 103, 0, 0, 15, 0, 0, 0, 48, 0, 5, 0, 0, 0, 0, 0, 0, 0, 0, 0, 0, 1, 2, 7, 2, 0, 0, 0, 5, 12, 0, 0, 80, 10, 1, 0, 0, 0, 28, 0, 0, 0, 0, 0, 50, 2, 1, 0, 0, 1, 0, 0, 0, 6, 0, 38, 0, 0, 0, 0, 0, 0, 22, 0, 0, 1, 0, 62, 0, 0, 1, 0, 0, 0, 3, 0, 0, 0, 11, 0, 10, 1, 0, 0, 0, 0, 0, 16, 0, 0, 0, 15, 0, 3, 0, 0, 0, 1, 0, 0, 0, 0, 0, 12, 0, 0, 0, 0, 0, 12, 0, 1, 0, 0, 1, 41, 4, 0, 0, 12, 10, 0, 0, 0, 0, 0, 11, 0, 18, 0, 0, 0, 4, 30, 0, 0, 0, 0, 0, 0, 0, 18, 0, 0, 0, 0, 0, 19, 2, 8, 0, 73, 84, 0, 0, 0, 7, 0, 19, 41, 3, 1, 0, 0, 0, 0, 0, 2, 32, 0, 0, 14, 0, 8, 0, 0, 0, 0, 0, 0, 0, 0, 0, 0, 0, 0, 0, 1, 8, 0, 0, 0, 0, 0, 0, 0, 23, 0, 1, 0, 0, 0, 0, 0, 0, 0, 0, 0, 15, 0, 0, 9, 2, 0, 0, 2, 7, 0, 1, 0, 1, 1, 52, 0, 0, 0, 0, 2, 0, 3, 0, 0, 0, 0, 0, 0, 57, 1, 0, 13, 2, 1, 0, 0, 0, 0, 0, 3, 4, 0, 7, 2, 0, 0, 0, 19, 0, 0, 0, 13, 0, 0, 0, 0, 0, 0, 0, 0, 0, 3, 0, 0, 0, 2, 0, 0, 5, 71, 0, 0, 16, 0, 0, 0, 0, 8, 1, 0, 0, 5, 7, 1, 0, 0, 0, 1, 0, 0, 0, 0, 0, 4, 1, 0, 0, 0, 0, 0, 0, 3, 0, 0, 0, 364, 78, 0, 0, 11, 0, 0, 0, 1, 2, 3, 1, 0, 0, 23, 0, 0, 36, 13, 0, 0, 2, 3, 0, 0, 0, 18, 0, 0, 0, 0, 0, 0, 0, 14, 1, 2, 0, 10, 2, 2, 125, 8, 0, 0, 0, 0, 0, 0, 0, 0, 2, 1, 0, 0, 0, 0, 0, 1, 0, 0, 0, 0, 3, 0, 0, 7, 44, 2, 12, 0, 0, 9, 1, 0, 0, 3, 9, 0, 0, 0, 6, 0, 29, 0, 0, 0, 2, 0, 14, 0, 1, 0, 0, 0, 16, 0, 0, 0, 3, 0, 2, 0, 11, 0, 5, 0, 2, 0, 1, 65, 0, 0, 0, 0, 0, 0, 0, 1, 3, 28, 0, 0, 16, 0, 0, 7, 1, 13, 13, 0, 2, 0, 3, 0, 27, 0, 0, 0, 1, 0, 1, 0, 2, 0, 0, 0, 0, 1, 1, 0, 0, 3, 1, 6, 0, 0, 10, 0, 19, 0, 0, 0, 3, 1, 0, 0, 0, 0, 1, 0, 0, 0, 0, 0, 0, 0, 4, 0, 17, 0, 0, 0, 2, 12, 0, 0, 0, 0, 0, 0, 0, 15, 1, 2, 0, 0, 0, 6, 0, 123, 11, 1, 0, 0, 0, 0, 0, 1, 0, 0, 0, 0, 0, 16, 0, 0, 0, 1, 0, 0, 1, 0, 0, 3, 0, 6, 0, 1, 0, 0, 0, 0, 0, 0, 1, 0, 16, 0, 0, 0, 0, 0, 0, 0, 0, 0, 0, 9, 0, 0, 1, 4, 2, 0, 0, 0, 0, 10, 0, 420, 0, 57, 0, 0, 0, 0, 1, 0, 0, 0, 0, 0, 3, 0, 2, 4, 10, 6, 2, 0, 14, 0, 1, 0, 13, 19, 22, 1, 0, 0, 2, 0, 0, 1, 0, 0, 11, 1, 0, 0, 0, 0, 0, 0, 0, 5, 0, 38, 0, 0, 0, 12, 0, 6, 0, 0, 0, 3, 0, 0, 8, 3, 1, 65, 0, 0, 6, 13, 1, 0, 1, 0, 0, 3, 6, 4, 0, 0, 0, 0, 15, 0, 0, 0, 0, 3, 15, 0, 0, 1, 9, 2, 0, 45, 0, 39, 0, 0, 0, 0, 0, 5, 28, 1, 26, 8, 7, 0, 0, 0, 0, 1, 0, 2, 1, 0, 0, 0, 0, 0, 15, 0, 37, 0, 0, 0, 3, 0, 0, 0, 4, 31, 5, 414, 0, 16, 0, 0, 11, 0, 0, 0, 0, 46, 54, 3, 2, 0, 3, 0, 0, 1, 0, 0, 0, 0, 0, 0, 1, 13, 0, 3, 0, 0, 1, 0, 0, 12, 0, 12, 0, 0, 0, 4, 0, 0, 0, 10, 9, 0, 6, 0, 0, 0, 0, 0, 0, 0, 1, 0, 4, 27, 8, 3
The-Google-Story-Inside-the-Hottest-Business_-Media_-and-Technology-Success-of-Our-Time-by-Brin_-Ser, 0, 0, 0, 19, 73, 0, 0, 0, 0, 42, 17, 31, 1, 0, 0, 0, 2, 0, 0, 0, 0, 0, 0, 47, 0, 0, 0, 0, 1, 0, 0, 0, 0, 0, 0, 0, 0, 2, 61, 0, 6, 0, 10, 0, 0, 0, 0, 3, 5, 0, 0, 20, 0, 0, 0, 0, 0, 0, 0, 0, 106, 0, 0, 0, 4, 7, 0, 12, 0, 0, 0, 0, 0, 0, 26, 0, 0, 0, 22, 0, 0, 0, 0, 0, 0, 33, 0, 7, 0, 75, 0, 0, 14, 0, 0, 0, 1, 0, 2, 7, 0, 0, 0, 0, 0, 0, 1, 0, 5, 0, 2, 14, 0, 0, 0, 20, 302, 0, 0, 0, 0, 0, 0, 0, 3, 149, 1, 0, 0, 0, 13, 0, 0, 0, 0, 0, 0, 0, 0, 2, 0, 0, 0, 0, 0, 4, 38, 0, 0, 0, 0, 0, 0, 0, 23, 5, 242, 0, 30, 2, 13, 29, 0, 0, 7, 0, 5, 0, 2, 2, 0, 0, 0, 41, 0, 0, 0, 0, 10, 15, 0, 15, 0, 44, 0, 0, 0, 8, 0, 10, 0, 0, 0, 0, 16, 1, 0, 6, 16, 0, 0, 4, 0, 71, 0, 0, 4, 0, 3, 0, 37, 8, 10, 0, 18, 0, 0, 0, 0, 13, 0, 0, 0, 0, 9, 0, 0, 0, 4, 0, 0, 0, 0, 0, 0, 0, 24, 0, 12, 0, 0, 3, 1, 70, 0, 0, 0, 0, 1, 0, 46, 0, 0, 0, 145, 0, 31, 0, 0, 0, 0, 8, 14, 1, 0, 0, 2, 1, 0, 8, 2, 0, 14, 2, 10, 23, 7, 0, 0, 0, 10, 0, 0, 0, 13, 0, 0, 0, 0, 31, 0, 11, 44, 0, 5, 1, 0, 24, 1, 7, 0, 161, 0, 0, 0, 14, 12, 0, 0, 20, 34, 0, 0, 0, 23, 14, 0, 3, 0, 0, 17, 0, 0, 20, 0, 0, 0, 0, 68, 0, 0, 13, 0, 4, 0, 31, 0, 0, 0, 0, 4, 0, 0, 0, 0, 0, 25, 0, 0, 8, 0, 6, 6, 0, 14, 0, 0, 22, 0, 0, 25, 0, 0, 0, 0, 0, 3, 0, 51, 0, 0, 0, 32, 4, 0, 0, 2, 7, 0, 51, 49, 0, 6, 0, 0, 7, 9, 0, 2, 0, 3, 11, 0, 0, 0, 0, 0, 0, 0, 0, 0, 0, 0, 0, 0, 0, 0, 0, 0, 17, 47, 0, 0, 1581, 8, 0, 0, 0, 0, 0, 0, 0, 4, 1, 0, 1, 0, 0, 113, 0, 0, 9, 0, 0, 1, 0, 43, 0, 43, 1, 0, 14, 0, 3, 42, 0, 0, 0, 0, 0, 0, 0, 0, 1, 84, 0, 30, 30, 0, 1, 0, 275, 120, 1, 3, 0, 20, 0, 0, 2, 0, 0, 0, 0, 0, 0, 0, 0, 1, 5, 0, 0, 4, 0, 1, 0, 27, 0, 3, 0, 0, 0, 0, 1, 0, 0, 8, 1, 10, 7, 0, 1, 0, 20, 0, 0, 0, 0, 0, 0, 0, 0, 2, 0, 20, 61, 0, 4, 0, 0, 1, 0, 32, 0, 0, 15, 0, 2, 0, 1, 6, 0, 0, 0, 0, 1, 5, 10, 0, 0, 10, 5, 0, 2, 2, 0, 2, 0, 0, 0, 0, 0, 0, 0, 0, 0, 22, 0, 0, 10, 193, 0, 0, 0, 0, 0, 30, 32, 0, 0, 40, 0, 0, 1, 0, 0, 1, 46, 0, 0, 3, 0, 0, 0, 2, 0, 0, 0, 0, 0, 0, 0, 8, 0, 0, 10, 0, 5, 1, 10, 0, 0, 0, 51, 0, 0, 0, 0, 0, 11, 27, 1, 76, 0, 6, 0, 0, 11, 1, 0, 0, 3, 0, 0, 32, 2, 0, 37, 2, 7, 0, 11, 0, 3, 0, 0, 77, 0, 0, 2, 1, 12, 0, 0, 6, 0, 98, 0, 1, 0, 125, 0, 16, 0, 4, 0, 0, 133, 0, 0, 0, 0, 51, 0, 0, 5, 2, 0, 2, 0, 0, 0, 0, 0, 6, 18, 0, 13, 0, 0, 1, 47, 0, 0, 55, 0, 0, 0, 4, 3, 0, 28, 0, 0, 6, 0, 0, 0, 0, 0, 35, 1, 0, 0, 0, 0, 48, 30, 0, 0, 0, 29, 0, 0, 36, 0, 18, 0, 0, 0, 0, 5, 0, 0, 0, 17, 0, 4, 0, 0, 0, 30, 8, 5, 0, 0, 0, 0, 0, 0, 0, 0, 0, 0, 0, 11, 0, 0, 0, 40, 0, 1, 17, 0, 14, 0, 0, 4, 0, 0, 3, 0, 0, 0, 0, 0, 0, 0, 34, 0, 0, 0, 0, 75, 5, 2, 11, 0, 0, 13, 52, 0, 0, 4, 0, 74, 34, 0, 19, 5, 0, 0, 0, 3, 0, 0, 27, 0, 3, 0, 0, 0, 0, 0, 0, 0, 0, 28, 0, 0, 0, 5, 0, 0, 0, 0, 0, 0, 10, 27, 0, 0, 6, 0, 0, 0, 0, 13, 10, 0, 65, 0, 5, 4, 0, 2, 1, 4, 0, 0, 0, 0, 6, 0, 0, 0, 2, 15, 61, 17, 4, 0, 2, 0, 0, 0, 72, 0, 0, 0, 0, 2, 0, 0, 0, 0, 3, 0, 0, 0, 0, 659, 0, 0, 0, 0, 3, 3, 0, 1, 0, 18, 9, 0, 0, 0, 52, 0, 0, 268, 54, 0, 4, 0, 0, 19, 0, 18, 0, 0, 2, 13, 22, 0, 1, 2, 0, 0, 1, 0, 0, 0, 0, 19, 0, 0, 0, 0, 0, 0, 0, 0, 0, 0, 0, 2, 0, 1, 0, 0, 0, 0, 12, 68, 7, 0, 0, 0, 1, 93, 0, 0, 40, 0, 0, 0, 0, 0, 0, 0, 4, 0, 0, 0, 8, 0, 0, 58, 1, 0, 7, 1, 0, 2, 69, 20, 0, 1, 0, 0, 0, 10, 0, 0, 3, 0, 0, 0, 31, 0, 0, 0, 16, 0, 0, 0, 58, 0, 0, 55, 0, 0, 1, 108, 0, 16, 0, 0, 0, 0, 0, 0, 0, 0, 0, 0, 1, 8, 11, 4, 0, 0, 0, 17, 27, 1, 0, 102, 17, 3, 2, 0, 0, 31, 0, 0, 0, 1, 0, 38, 6, 0, 0, 1, 2, 0, 0, 0, 4, 0, 75, 0, 0, 0, 1, 0, 0, 4, 0, 0, 1, 0, 80, 1, 0, 5, 0, 0, 0, 14, 0, 1, 0, 6, 0, 9, 1, 1, 0, 0, 0, 0, 36, 0, 0, 0, 29, 0, 13, 0, 0, 0, 1, 0, 0, 0, 0, 0, 39, 0, 0, 0, 0, 0, 61, 0, 10, 0, 0, 1, 60, 32, 0, 0, 57, 29, 5, 0, 0, 0, 0, 26, 0, 64, 0, 0, 0, 13, 34, 0, 0, 0, 0, 0, 0, 11, 67, 0, 0, 2, 0, 1, 33, 4, 21, 0, 52, 242, 0, 0, 0, 11, 0, 20, 82, 7, 1, 0, 0, 0, 0, 0, 2, 63, 1, 0, 3, 0, 15, 0, 0, 0, 0, 0, 0, 0, 0, 0, 0, 0, 0, 0, 0, 13, 0, 0, 0, 0, 0, 0, 1, 27, 0, 1, 0, 2, 0, 0, 0, 0, 0, 0, 1, 20, 0, 0, 26, 0, 0, 0, 3, 1, 0, 13, 0, 1, 41, 88, 0, 0, 0, 0, 55, 0, 1, 2, 1, 0, 0, 0, 0, 164, 3, 0, 29, 2, 3, 1, 1, 0, 0, 0, 3, 8, 0, 8, 0, 0, 0, 0, 36, 7, 0, 0, 12, 1, 0, 0, 0, 1, 0, 0, 0, 0, 2, 0, 0, 0, 3, 0, 1, 12, 90, 0, 0, 8, 0, 0, 0, 0, 36, 0, 0, 0, 3, 16, 4, 0, 0, 0, 3, 0, 0, 0, 0, 0, 1, 1, 0, 0, 0, 0, 0, 0, 1, 0, 0, 0, 445, 58, 0, 0, 10, 0, 0, 0, 0, 2, 1, 3, 0, 0, 7, 2, 0, 34, 1, 0, 0, 6, 3, 0, 0, 0, 9, 0, 0, 0, 0, 2, 0, 0, 22, 2, 7, 0, 26, 2, 13, 85, 14, 0, 0, 0, 0, 0, 0, 0, 0, 6, 5, 0, 0, 1, 0, 0, 2, 0, 0, 0, 0, 25, 0, 0, 7, 31, 6, 19, 1, 0, 10, 12, 0, 0, 21, 10, 0, 0, 0, 5, 0, 0, 0, 0, 0, 0, 0, 28, 0, 7, 0, 0, 0, 14, 0, 0, 0, 4, 0, 22, 0, 19, 0, 9, 0, 0, 0, 4, 68, 0, 0, 0, 0, 0, 0, 1, 0, 5, 30, 0, 0, 15, 1, 0, 24, 8, 27, 12, 0, 32, 0, 7, 1, 60, 0, 2, 0, 0, 0, 1, 0, 6, 0, 0, 0, 0, 12, 0, 0, 0, 33, 4, 12, 0, 0, 25, 0, 64, 0, 0, 0, 0, 0, 0, 0, 0, 0, 2, 7, 82, 3, 0, 0, 0, 0, 33, 0, 55, 0, 0, 0, 8, 4, 0, 0, 1, 0, 0, 0, 0, 32, 0, 1, 0, 2, 0, 0, 0, 227, 22, 4, 0, 0, 0, 0, 0, 0, 0, 0, 0, 1, 0, 17, 0, 0, 0, 1, 0, 0, 0, 0, 0, 5, 4, 2, 0, 10, 0, 0, 0, 0, 0, 0, 0, 0, 39, 0, 0, 0, 24, 0, 0, 1, 0, 0, 0, 5, 0, 0, 0, 2, 1, 0, 0, 0, 0, 0, 0, 248, 0, 115, 0, 0, 0, 0, 1, 0, 0, 0, 0, 0, 1, 0, 3, 0, 10, 9, 2, 0, 45, 1, 0, 0, 20, 7, 40, 0, 0, 2, 0, 0, 0, 8, 0, 0, 18, 7, 0, 0, 0, 0, 0, 0, 0, 52, 0, 66, 0, 0, 0, 22, 0, 13, 1, 0, 0, 2, 0, 0, 4, 1, 12, 160, 0, 0, 42, 28, 0, 0, 0, 0, 0, 8, 3, 3, 3, 0, 0, 0, 7, 0, 0, 2, 0, 4, 20, 0, 0, 0, 15, 2, 0, 59, 0, 12, 0, 0, 0, 0, 0, 27, 56, 0, 77, 22, 3, 0, 0, 0, 0, 0, 0, 5, 1, 0, 0, 0, 0, 0, 24, 0, 41, 0, 0, 0, 7, 0, 0, 0, 2, 13, 5, 246, 0, 14, 1, 0, 34, 0, 0, 0, 0, 78, 52, 0, 1, 2, 0, 2, 0, 0, 4, 0, 3, 0, 0, 0, 0, 19, 0, 13, 0, 0, 1, 1, 0, 49, 0, 23, 0, 0, 5, 17, 0, 0, 0, 1, 20, 0, 17, 0, 0, 0, 0, 0, 0, 0, 4, 0, 6, 30, 5, 6
The-House-of-Morgan-An-American-Banking-Dynasty-and-the-Rise-of-Modern-Finance-by-Ron-Chernow-_z-lib, 0, 0, 0, 116, 47, 0, 0, 0, 0, 70, 0, 159, 8, 0, 0, 0, 23, 0, 0, 0, 0, 0, 0, 8, 1, 0, 0, 2, 14, 3, 0, 0, 0, 24, 0, 0, 0, 0, 275, 0, 52, 0, 469, 1, 0, 0, 0, 15, 0, 0, 0, 123, 0, 0, 0, 7, 0, 0, 1, 9, 277, 0, 0, 0, 441, 0, 0, 161, 26, 9, 11, 0, 3, 4, 17, 3, 0, 0, 329, 0, 1, 0, 0, 0, 0, 94, 0, 17, 0, 189, 0, 0, 13, 19, 0, 0, 1, 9, 13, 25, 129, 0, 0, 0, 0, 0, 0, 0, 251, 0, 0, 42, 0, 0, 0, 62, 0, 14, 3, 0, 0, 1, 3, 0, 17, 329, 1, 0, 0, 0, 51, 0, 0, 10, 0, 0, 6, 0, 0, 38, 0, 0, 0, 0, 4, 1, 152, 0, 0, 0, 0, 1, 5, 0, 22, 11, 11, 0, 149, 12, 0, 62, 0, 0, 29, 0, 24, 2, 64, 91, 0, 7, 0, 27, 1, 0, 9, 1, 30, 179, 0, 142, 0, 89, 0, 0, 0, 38, 0, 16, 0, 0, 4, 3, 150, 8, 0, 15, 4, 0, 0, 60, 2, 144, 1, 1, 1, 0, 26, 3, 29, 27, 6, 0, 83, 0, 0, 0, 0, 13, 0, 0, 0, 0, 26, 0, 0, 0, 3, 0, 1, 2, 0, 0, 0, 0, 16, 0, 0, 4, 0, 50, 137, 0, 2, 0, 0, 13, 0, 0, 44, 0, 0, 0, 390, 0, 112, 0, 0, 1, 0, 14, 21, 0, 0, 0, 4, 2, 0, 37, 8, 0, 55, 8, 262, 28, 0, 8, 10, 0, 160, 0, 0, 0, 34, 0, 0, 1, 9, 48, 0, 67, 9, 19, 1, 16, 0, 58, 16, 47, 23, 7, 5, 0, 0, 228, 101, 0, 0, 0, 50, 0, 0, 0, 0, 16, 781, 14, 0, 2, 9, 0, 0, 12, 0, 0, 0, 0, 58, 0, 0, 22, 0, 244, 12, 0, 0, 0, 0, 0, 0, 0, 0, 0, 0, 0, 70, 0, 0, 399, 1, 89, 2, 0, 63, 5, 3, 173, 0, 0, 22, 0, 254, 0, 0, 0, 32, 0, 28, 1, 0, 0, 1, 24, 0, 0, 101, 61, 3, 50, 0, 1, 22, 0, 0, 26, 8, 0, 17, 0, 782, 13, 0, 0, 0, 0, 9, 4, 0, 0, 0, 0, 6, 0, 0, 0, 0, 0, 0, 554, 6, 0, 0, 0, 11, 3, 3, 0, 0, 1, 0, 0, 3, 0, 0, 26, 0, 0, 53, 0, 1, 2, 0, 6, 69, 0, 0, 2, 67, 10, 4, 9, 0, 666, 153, 0, 2, 0, 0, 0, 0, 8, 10, 0, 10, 0, 94, 37, 1, 1, 0, 469, 0, 9, 45, 0, 80, 0, 0, 0, 0, 0, 0, 0, 0, 0, 0, 0, 0, 85, 0, 0, 62, 1, 0, 0, 85, 0, 1, 0, 0, 0, 0, 0, 0, 0, 11, 5, 50, 282, 0, 2, 0, 35, 0, 0, 0, 2, 0, 137, 0, 2, 17, 0, 87, 133, 0, 9, 2, 4, 1, 0, 62, 0, 0, 140, 0, 2, 0, 12, 15, 0, 3, 2, 0, 16, 4, 47, 0, 0, 44, 96, 1, 19, 5, 0, 0, 34, 0, 5, 0, 1, 12, 0, 0, 0, 119, 0, 0, 14, 0, 0, 0, 10, 0, 0, 0, 18, 1, 0, 86, 7, 2, 14, 0, 0, 19, 88, 0, 0, 13, 2, 0, 1, 54, 18, 0, 0, 0, 0, 1, 1, 69, 0, 0, 6, 0, 31, 28, 188, 0, 0, 0, 96, 0, 0, 0, 0, 23, 374, 297, 1, 789, 1, 73, 0, 0, 28, 219, 0, 0, 3, 0, 0, 93, 3, 0, 37, 10, 17, 0, 129, 0, 23, 0, 0, 165, 0, 0, 0, 0, 119, 0, 0, 46, 0, 94, 0, 0, 0, 0, 124, 68, 0, 4, 11, 2, 530, 0, 0, 0, 7, 13, 0, 2, 0, 146, 0, 7, 0, 3, 0, 2, 0, 5, 47, 42, 4, 0, 0, 3, 58, 2, 0, 49, 2, 0, 6, 59, 7, 26, 28, 0, 0, 8, 9, 0, 1, 0, 4, 31, 25, 0, 0, 0, 0, 45, 35, 0, 0, 0, 288, 0, 0, 94, 0, 107, 0, 0, 0, 0, 1, 0, 0, 0, 117, 0, 10, 12, 11, 0, 0, 46, 26, 0, 0, 0, 0, 1, 0, 0, 0, 0, 0, 129, 22, 3, 0, 0, 25, 0, 26, 91, 0, 0, 0, 3, 0, 1, 1, 67, 0, 0, 0, 0, 0, 0, 0, 69, 0, 1, 0, 0, 81, 1, 5, 77, 0, 0, 4, 17, 29, 0, 10, 0, 312, 88, 0, 23, 23, 0, 0, 0, 20, 1, 0, 90, 74, 0, 0, 0, 2, 0, 0, 0, 9, 0, 33, 0, 72, 0, 7, 0, 3, 0, 0, 0, 0, 45, 0, 6, 11, 33, 0, 9, 0, 0, 6, 13, 0, 109, 0, 46, 20, 0, 4, 217, 0, 956, 20, 4, 0, 7, 0, 101, 0, 10, 28, 8, 112, 24, 0, 10, 0, 0, 0, 27, 0, 0, 0, 10, 38, 0, 0, 0, 3, 9, 0, 25, 0, 0, 10, 127, 0, 0, 0, 14, 42, 11, 57, 52, 31, 14, 1, 0, 0, 72, 0, 3, 324, 36, 0, 152, 46, 0, 55, 0, 43, 3, 0, 83, 101, 14, 0, 1, 19, 0, 0, 0, 0, 0, 0, 0, 390, 0, 0, 0, 0, 57, 0, 0, 0, 0, 7, 5, 76, 4, 2, 0, 4, 0, 2, 51, 0, 176, 0, 2, 13, 4, 0, 0, 1, 12, 0, 0, 3, 0, 0, 0, 0, 10, 0, 0, 0, 2, 0, 6, 118, 28, 0, 16, 2, 0, 28, 0, 15, 0, 7, 3, 1, 0, 1, 0, 0, 301, 1, 0, 60, 219, 0, 0, 0, 46, 0, 0, 1, 110, 1, 0, 150, 7, 0, 6, 337, 0, 27, 39, 0, 0, 0, 7, 2, 5, 0, 0, 0, 5, 88, 37, 2, 0, 0, 1, 9, 1, 29, 0, 12, 11, 1, 2, 4, 0, 178, 0, 16, 1, 3, 0, 76, 97, 0, 0, 0, 49, 3, 0, 0, 4, 0, 94, 0, 0, 0, 6, 0, 0, 0, 0, 0, 13, 0, 87, 0, 0, 280, 4, 0, 0, 133, 0, 10, 0, 0, 6, 100, 6, 1, 14, 0, 0, 0, 87, 10, 0, 0, 28, 0, 61, 0, 0, 0, 63, 4, 0, 0, 0, 31, 193, 0, 0, 186, 0, 0, 328, 0, 8, 0, 14, 38, 341, 4, 0, 0, 84, 98, 0, 0, 0, 33, 0, 128, 0, 182, 0, 0, 0, 59, 81, 0, 0, 0, 0, 1, 26, 13, 66, 5, 0, 6, 0, 15, 26, 1, 12, 13, 98, 4, 0, 0, 0, 5, 66, 95, 126, 40, 0, 0, 0, 0, 0, 0, 110, 43, 0, 0, 1, 0, 52, 2, 1, 1, 0, 22, 0, 2, 0, 0, 0, 0, 0, 2, 61, 14, 0, 0, 23, 0, 0, 0, 16, 63, 0, 2, 1, 0, 0, 0, 0, 0, 0, 8, 0, 15, 0, 0, 11, 26, 472, 0, 65, 0, 0, 16, 8, 14, 17, 313, 3, 0, 0, 0, 0, 77, 0, 2, 2, 0, 0, 0, 2, 43, 125, 0, 142, 9, 228, 12, 70, 0, 0, 0, 1, 27, 0, 74, 7, 0, 0, 0, 14, 9, 0, 0, 42, 11, 0, 0, 22, 199, 0, 0, 0, 0, 38, 0, 0, 0, 0, 70, 1, 97, 19, 0, 0, 0, 0, 0, 3, 0, 95, 0, 0, 0, 44, 20, 0, 0, 0, 0, 1, 0, 1, 1, 0, 0, 104, 0, 0, 0, 0, 0, 0, 0, 27, 4, 0, 0, 684, 5, 0, 0, 23, 0, 0, 0, 0, 26, 0, 3881, 0, 0, 1707, 20, 0, 264, 6, 0, 1, 1, 3, 0, 67, 0, 333, 0, 0, 0, 0, 4, 0, 0, 108, 2, 0, 0, 57, 3, 38, 102, 24, 0, 0, 1, 0, 2, 0, 2, 0, 14, 1, 0, 0, 3, 0, 0, 0, 0, 0, 0, 0, 59, 0, 0, 1, 167, 82, 139, 0, 0, 25, 25, 0, 0, 48, 5, 0, 0, 0, 2, 0, 0, 1, 39, 0, 58, 0, 127, 0, 10, 16, 1, 8, 45, 1, 0, 0, 6, 0, 112, 0, 225, 0, 120, 0, 36, 0, 88, 134, 2, 4, 0, 0, 0, 0, 6, 0, 199, 208, 0, 3, 27, 0, 0, 31, 31, 36, 115, 0, 0, 8, 24, 1, 99, 0, 1, 0, 57, 0, 35, 0, 17, 0, 0, 0, 0, 11, 2, 0, 0, 25, 76, 2, 0, 0, 43, 0, 92, 6, 0, 8, 0, 6, 0, 0, 0, 0, 12, 4, 0, 6, 0, 0, 4, 141, 79, 0, 31, 0, 8, 1, 107, 69, 3, 0, 85, 0, 0, 2, 0, 54, 0, 53, 2, 0, 0, 10, 0, 484, 8, 9, 0, 0, 0, 0, 22, 304, 0, 107, 0, 10, 7, 5, 261, 33, 0, 162, 0, 0, 0, 59, 0, 54, 0, 0, 0, 33, 0, 0, 0, 0, 0, 1, 9, 0, 23, 49, 0, 0, 1, 0, 0, 0, 0, 0, 0, 95, 0, 0, 88, 22, 21, 0, 3, 0, 5, 0, 7, 2, 0, 2, 0, 5, 0, 0, 40, 0, 0, 0, 0, 0, 5, 21, 146, 0, 177, 24, 0, 0, 221, 0, 0, 0, 608, 16, 79, 0, 2, 39, 12, 0, 0, 8, 0, 0, 108, 4, 0, 0, 0, 8, 0, 0, 1, 50, 0, 2, 0, 0, 0, 28, 32, 20, 1, 119, 0, 123, 24, 2, 23, 32, 42, 386, 0, 0, 37, 109, 0, 4, 37, 2, 0, 18, 74, 53, 4, 0, 0, 7, 58, 0, 178, 14, 3, 98, 131, 0, 0, 9, 48, 0, 0, 136, 3, 19, 0, 0, 0, 0, 0, 9, 89, 1, 808, 54, 5, 0, 2, 0, 6, 16, 0, 15, 1, 0, 1, 1, 0, 0, 58, 11, 47, 2, 0, 0, 64, 0, 0, 0, 0, 6, 60, 0, 0, 23, 11, 0, 4, 0, 0, 79, 0, 29, 89, 0, 115, 1, 15, 1, 0, 19, 9, 0, 33, 0, 0, 14, 2, 92, 0, 76, 0, 0, 1, 0, 0, 0, 0, 21, 0, 0, 18, 708, 0, 0, 0, 10, 764, 4, 43, 0, 1, 0, 0, 0, 0, 0, 17, 1, 29, 150, 66, 15
The-King-of-Oil-The-Secret-Lives-of-Marc-Rich-by-Ammann_-Daniel, 0, 0, 0, 9, 49, 0, 0, 0, 0, 23, 0, 15, 4, 0, 0, 0, 0, 0, 0, 0, 0, 0, 9, 16, 0, 0, 0, 0, 1, 0, 0, 0, 0, 1, 0, 0, 0, 0, 35, 0, 7, 0, 77, 11, 0, 0, 0, 0, 0, 0, 0, 27, 0, 0, 0, 0, 0, 0, 0, 0, 55, 0, 0, 0, 12, 0, 0, 177, 0, 3, 0, 0, 0, 0, 2, 0, 0, 0, 46, 0, 0, 0, 0, 0, 0, 14, 0, 20, 0, 90, 0, 0, 2, 0, 0, 0, 0, 1, 0, 12, 2, 0, 0, 0, 0, 0, 0, 0, 1, 0, 0, 12, 0, 1, 0, 31, 0, 2, 3, 0, 0, 3, 32, 0, 28, 125, 0, 0, 0, 0, 4, 0, 0, 0, 0, 0, 0, 0, 0, 7, 0, 0, 0, 0, 0, 12, 26, 0, 0, 0, 0, 0, 2, 0, 3, 6, 1, 0, 33, 4, 0, 17, 0, 0, 0, 0, 16, 0, 105, 37, 0, 1, 0, 40, 0, 0, 0, 0, 11, 6, 0, 69, 0, 52, 0, 0, 0, 3, 0, 3, 0, 0, 22, 1, 32, 0, 0, 0, 7, 0, 0, 4, 0, 44, 0, 1, 20, 0, 6, 0, 13, 64, 1, 0, 18, 0, 0, 0, 0, 4, 0, 1, 0, 0, 20, 0, 0, 0, 1, 0, 0, 0, 0, 0, 0, 0, 2, 0, 0, 0, 0, 7, 1, 0, 0, 0, 0, 0, 0, 0, 19, 0, 0, 1, 13, 0, 41, 0, 0, 0, 21, 2, 1, 0, 0, 0, 4, 1, 0, 11, 0, 0, 7, 36, 23, 9, 7, 2, 0, 0, 43, 0, 0, 0, 6, 1, 0, 30, 2, 8, 0, 26, 3, 0, 0, 1, 0, 60, 2, 24, 0, 1, 2, 0, 0, 211, 43, 56, 0, 0, 48, 0, 0, 0, 0, 4, 0, 2, 0, 1, 3, 0, 0, 2, 0, 0, 0, 0, 29, 0, 0, 26, 0, 12, 98, 0, 0, 0, 24, 0, 2, 0, 0, 0, 0, 0, 33, 0, 0, 14, 0, 10, 7, 0, 22, 0, 0, 10, 0, 0, 10, 0, 0, 0, 0, 1, 6, 0, 7, 10, 0, 0, 0, 0, 0, 0, 40, 6, 2, 18, 0, 0, 18, 0, 0, 2, 0, 1, 6, 0, 8, 23, 0, 0, 0, 0, 1, 4, 0, 0, 0, 0, 0, 0, 0, 0, 0, 0, 0, 78, 1, 3, 0, 2, 4, 0, 0, 0, 0, 0, 0, 0, 1, 0, 0, 11, 0, 0, 27, 0, 0, 0, 0, 2, 11, 25, 0, 0, 32, 7, 0, 18, 0, 1, 55, 0, 1, 0, 0, 0, 0, 5, 9, 0, 11, 0, 45, 2, 0, 0, 0, 245, 0, 2, 10, 0, 9, 0, 0, 2, 0, 0, 0, 0, 0, 0, 0, 0, 0, 17, 0, 27, 12, 0, 0, 0, 60, 0, 0, 0, 0, 0, 0, 11, 0, 0, 2, 2, 11, 22, 0, 0, 0, 12, 0, 0, 0, 0, 0, 0, 0, 22, 4, 0, 26, 31, 0, 3, 0, 34, 1, 0, 6, 0, 0, 26, 0, 0, 0, 1, 1, 0, 0, 0, 0, 9, 0, 9, 0, 0, 11, 18, 0, 1, 1, 0, 2, 0, 0, 1, 0, 1, 5, 0, 0, 0, 3, 0, 0, 11, 2, 0, 0, 0, 0, 0, 0, 2, 0, 0, 24, 3, 0, 4, 0, 0, 1, 37, 0, 0, 78, 0, 0, 0, 4, 3, 0, 0, 0, 0, 0, 0, 9, 0, 0, 7, 0, 44, 1, 11, 0, 0, 0, 34, 0, 0, 0, 0, 8, 21, 21, 0, 21, 0, 82, 0, 0, 17, 3, 0, 0, 1, 2, 0, 24, 53, 0, 34, 1, 3, 0, 47, 0, 7, 0, 0, 161, 0, 0, 0, 66, 33, 0, 0, 16, 0, 4, 0, 0, 0, 0, 0, 80, 0, 2, 3, 0, 20, 0, 0, 0, 0, 15, 0, 0, 0, 8, 0, 1, 0, 0, 0, 0, 0, 2, 8, 1, 0, 0, 0, 0, 13, 0, 0, 12, 1, 0, 1, 0, 6, 0, 2, 0, 0, 2, 2, 0, 0, 0, 0, 15, 5, 0, 0, 0, 0, 21, 6, 0, 0, 0, 127, 0, 0, 40, 0, 8, 0, 0, 0, 0, 1, 0, 0, 0, 18, 0, 9, 0, 4, 0, 0, 9, 0, 0, 0, 0, 0, 2, 0, 0, 0, 0, 0, 0, 5, 5, 0, 0, 7, 0, 6, 6, 0, 0, 0, 0, 0, 0, 0, 11, 0, 0, 0, 0, 0, 0, 0, 34, 0, 1, 0, 0, 9, 0, 1, 13, 0, 0, 25, 1, 3, 0, 102, 0, 41, 8, 21, 14, 3, 0, 0, 0, 5, 71, 0, 27, 0, 0, 0, 0, 0, 0, 0, 0, 0, 0, 3, 0, 0, 0, 7, 0, 57, 0, 0, 0, 0, 10, 0, 0, 0, 25, 0, 1, 0, 0, 0, 2, 0, 70, 0, 41, 1, 123, 0, 0, 0, 0, 2, 1, 0, 57, 0, 0, 0, 0, 76, 2, 13, 6, 0, 3, 0, 0, 0, 11, 0, 0, 0, 1, 17, 0, 0, 0, 5, 1, 0, 0, 0, 0, 7, 1, 3, 0, 0, 0, 4, 0, 11, 182, 10, 16, 0, 0, 22, 2, 0, 1, 109, 19, 0, 21, 51, 0, 28, 0, 6, 0, 0, 2, 1609, 2, 0, 0, 6, 0, 0, 0, 0, 0, 0, 0, 150, 0, 0, 0, 0, 2, 0, 0, 1, 0, 0, 0, 38, 6, 2, 0, 40, 0, 0, 9, 0, 33, 0, 0, 4, 11, 0, 0, 0, 3, 0, 0, 0, 0, 0, 0, 0, 4, 0, 0, 0, 0, 0, 0, 33, 3, 0, 12, 3, 0, 2, 0, 2, 0, 0, 1, 0, 0, 6, 0, 0, 50, 0, 0, 0, 13, 0, 0, 0, 15, 0, 0, 0, 29, 0, 0, 40, 0, 0, 4, 26, 0, 19, 4, 0, 0, 5, 0, 1, 0, 0, 0, 1, 3, 29, 14, 0, 0, 0, 0, 2, 0, 5, 0, 0, 1, 0, 1, 0, 0, 100, 0, 4, 80, 0, 0, 27, 25, 0, 0, 1, 2, 1, 0, 0, 1, 0, 40, 0, 0, 0, 0, 0, 0, 0, 0, 0, 4, 0, 52, 0, 0, 17, 3, 0, 0, 98, 0, 0, 0, 0, 1, 5, 1, 0, 1, 0, 0, 0, 20, 6, 0, 0, 19, 0, 12, 9, 28, 0, 4, 0, 0, 0, 0, 0, 28, 0, 0, 0, 0, 0, 25, 0, 1, 0, 1, 6, 136, 5, 0, 0, 18, 34, 0, 0, 0, 2, 0, 9, 0, 104, 1, 0, 0, 12, 79, 0, 0, 0, 0, 0, 2, 1, 57, 0, 0, 58, 0, 125, 3, 1, 1, 0, 10, 0, 0, 0, 0, 0, 0, 17, 1, 18, 0, 0, 0, 0, 0, 0, 2, 21, 0, 0, 3, 1, 8, 0, 0, 1, 0, 0, 0, 1, 0, 0, 0, 0, 0, 0, 13, 10, 0, 0, 1, 0, 0, 0, 5, 11, 117, 11, 0, 0, 0, 0, 0, 0, 0, 0, 0, 16, 0, 0, 2, 0, 0, 0, 2, 0, 0, 5, 1, 2, 4, 113, 0, 0, 0, 0, 0, 0, 0, 2, 0, 0, 0, 0, 0, 35, 0, 0, 38, 2, 6, 1, 0, 0, 0, 0, 0, 1, 76, 14, 4, 0, 0, 0, 2, 1, 0, 0, 12, 20, 0, 0, 2, 7, 0, 0, 0, 0, 6, 0, 0, 0, 0, 0, 3, 27, 12, 0, 0, 0, 0, 0, 0, 0, 32, 0, 0, 0, 14, 1, 0, 0, 0, 0, 0, 1, 0, 0, 0, 0, 597, 0, 0, 0, 0, 0, 0, 0, 71, 6, 23, 0, 387, 2, 0, 0, 8, 0, 0, 0, 0, 1, 1, 1, 0, 0, 46, 0, 0, 149, 3, 0, 1, 0, 1, 0, 2, 0, 15, 0, 0, 0, 0, 90, 0, 0, 25, 0, 0, 0, 19, 0, 11, 33, 15, 0, 0, 0, 0, 0, 0, 0, 0, 0, 0, 0, 26, 2, 0, 0, 3, 0, 0, 0, 0, 10, 0, 0, 0, 27, 20, 16, 438, 0, 11, 11, 0, 0, 4, 7, 0, 0, 0, 4, 0, 0, 0, 0, 0, 0, 0, 26, 0, 2, 3, 0, 0, 4, 0, 0, 0, 3, 0, 24, 0, 64, 0, 86, 0, 4, 5, 49, 29, 0, 0, 0, 0, 0, 0, 0, 0, 41, 13, 0, 0, 2, 2, 0, 20, 10, 34, 24, 0, 0, 6, 4, 0, 39, 0, 20, 0, 15, 0, 6, 0, 10, 7, 0, 0, 4, 0, 0, 0, 0, 19, 9, 3, 0, 22, 41, 0, 9, 0, 0, 1, 0, 0, 0, 19, 0, 0, 35, 1, 0, 0, 0, 0, 0, 0, 39, 0, 5, 0, 0, 1, 37, 15, 0, 0, 1, 0, 0, 5, 0, 20, 3, 19, 0, 0, 0, 1, 0, 243, 6, 4, 0, 0, 0, 0, 0, 5, 0, 0, 0, 25, 0, 1, 0, 1, 0, 11, 0, 0, 0, 0, 0, 6, 0, 2, 0, 19, 0, 0, 0, 4, 6, 8, 1, 0, 11, 0, 0, 0, 0, 0, 0, 0, 0, 0, 0, 27, 0, 0, 1, 2, 1, 0, 129, 0, 5, 0, 6, 0, 0, 0, 0, 0, 0, 0, 84, 0, 0, 37, 2, 0, 7, 7, 7, 5, 60, 5, 0, 0, 59, 0, 0, 0, 57, 13, 15, 0, 73, 1, 0, 0, 0, 1, 0, 0, 22, 4, 0, 0, 0, 0, 0, 0, 0, 3, 0, 1, 0, 0, 0, 4, 6, 2, 1, 0, 0, 3, 0, 0, 16, 0, 3, 106, 0, 0, 27, 40, 0, 0, 1, 0, 0, 3, 65, 16, 0, 0, 0, 0, 0, 0, 0, 0, 0, 167, 24, 0, 0, 4, 51, 0, 0, 38, 8, 17, 0, 0, 0, 0, 0, 0, 71, 7, 12, 20, 0, 23, 0, 0, 0, 6, 0, 43, 0, 0, 0, 1, 0, 0, 51, 0, 16, 0, 0, 0, 3, 0, 0, 0, 0, 6, 29, 0, 0, 11, 6, 0, 28, 0, 0, 6, 0, 11, 40, 0, 7, 13, 11, 8, 0, 4, 1, 0, 3, 0, 0, 5, 0, 31, 0, 8, 0, 0, 2, 0, 0, 0, 0, 15, 0, 0, 1, 123, 0, 0, 22, 0, 47, 0, 16, 0, 1, 0, 0, 0, 0, 0, 127, 0, 7, 40, 35, 142
The-Lion-Wakes-A-Modern-History-of-HSBC-by-David-Kynaston-Richard-Roberts-_z-lib.org_, 0, 0, 0, 263, 50, 0, 0, 0, 0, 139, 0, 13, 0, 0, 0, 0, 59, 0, 0, 0, 0, 1, 0, 107, 0, 0, 0, 0, 44, 1, 3, 0, 0, 66, 1877, 0, 0, 15, 137, 0, 28, 0, 45, 22, 0, 0, 0, 317, 0, 2, 0, 76, 0, 0, 0, 0, 0, 0, 0, 0, 87, 8, 0, 0, 185, 0, 0, 24, 9, 3, 0, 0, 0, 0, 2, 4, 0, 0, 38, 0, 0, 1, 0, 0, 0, 99, 0, 0, 0, 114, 4, 0, 1, 0, 0, 0, 0, 5, 3, 9, 79, 0, 0, 0, 0, 0, 0, 0, 326, 1, 0, 34, 0, 2, 0, 59, 0, 4, 1, 0, 0, 0, 0, 0, 1, 242, 1, 0, 0, 0, 3, 0, 0, 15, 0, 0, 0, 0, 94, 6, 0, 2, 1, 0, 0, 32, 190, 0, 1, 0, 0, 0, 1, 0, 25, 31, 4, 0, 111, 25, 7, 31, 0, 0, 0, 0, 14, 2, 62, 25, 0, 0, 5, 159, 0, 0, 0, 0, 62, 148, 0, 31, 0, 132, 0, 0, 0, 27, 0, 5, 0, 0, 0, 2, 158, 2, 0, 5, 33, 0, 0, 9, 0, 213, 4, 0, 16, 6, 11, 6, 63, 10, 1, 7, 20, 0, 0, 0, 0, 73, 0, 0, 0, 0, 4, 0, 0, 0, 1, 0, 8, 0, 0, 5, 0, 0, 23, 0, 0, 0, 0, 49, 24, 5, 0, 0, 0, 32, 0, 1, 25, 0, 0, 0, 59, 0, 41, 8, 0, 0, 0, 25, 12, 0, 0, 0, 0, 0, 0, 8, 50, 0, 82, 4, 56, 24, 0, 0, 1, 0, 9, 0, 0, 0, 3, 1, 0, 0, 6, 32, 0, 54, 1, 300, 1, 9, 1, 52, 0, 34, 42, 26, 1, 0, 0, 262, 114, 1, 0, 1, 62, 0, 0, 3, 1, 66, 0, 14, 81, 0, 16, 0, 0, 60, 1, 0, 0, 0, 58, 0, 0, 11, 0, 14, 17, 0, 0, 0, 0, 0, 0, 0, 0, 0, 0, 0, 95, 25, 0, 140, 3, 47, 3, 0, 172, 0, 0, 232, 0, 0, 22, 0, 0, 0, 0, 0, 14, 0, 35, 0, 0, 1, 0, 3, 0, 0, 133, 2, 0, 69, 0, 0, 11, 0, 0, 31, 3, 0, 16, 0, 144, 28, 0, 0, 0, 0, 0, 0, 0, 0, 0, 0, 0, 0, 8, 131, 0, 0, 0, 118, 13, 0, 0, 0, 7, 0, 3, 0, 0, 0, 0, 0, 5, 0, 0, 2, 0, 0, 19, 0, 0, 3, 0, 20, 18, 0, 0, 0, 8, 1, 0, 119, 0, 16, 44, 0, 1, 0, 0, 0, 0, 2, 2, 0, 22, 0, 209, 122, 0, 4, 0, 515, 1, 1, 0, 0, 99, 0, 0, 0, 0, 0, 0, 0, 0, 0, 0, 0, 0, 8, 0, 0, 72, 0, 0, 0, 27, 0, 3, 0, 0, 0, 0, 1, 0, 0, 1, 1, 6, 194, 0, 0, 0, 12, 0, 0, 0, 0, 0, 0, 0, 5, 31, 0, 144, 46, 0, 16, 28, 1, 0, 0, 76, 0, 0, 245, 0, 2, 0, 9, 36, 0, 0, 0, 0, 10, 14, 14, 0, 0, 10, 30, 1, 0, 4, 0, 0, 0, 0, 8, 0, 21, 1, 0, 0, 0, 216, 0, 0, 30, 41, 0, 0, 0, 0, 0, 0, 1, 0, 0, 103, 0, 0, 3, 0, 0, 2, 152, 0, 0, 9, 0, 0, 0, 4, 9, 0, 0, 24, 0, 0, 0, 30, 0, 0, 19, 9, 9, 12, 6, 0, 0, 6, 98, 0, 0, 0, 0, 2, 179, 124, 3, 49, 0, 10, 0, 0, 73, 64, 0, 0, 5, 1, 0, 74, 2, 0, 55, 2, 5, 0, 65, 0, 1, 0, 0, 157, 1, 0, 31, 0, 169, 0, 0, 24, 0, 136, 2, 0, 0, 0, 0, 5, 0, 1, 0, 0, 65, 0, 0, 0, 0, 85, 0, 2, 0, 2, 0, 5, 0, 0, 0, 0, 0, 78, 61, 18, 0, 0, 0, 1, 49, 0, 0, 14, 27, 1, 0, 33, 1, 0, 13, 0, 0, 73, 30, 0, 3, 0, 0, 458, 99, 0, 0, 0, 0, 124, 20, 0, 5, 0, 29, 0, 0, 45, 1, 133, 0, 0, 0, 0, 4, 0, 21, 100, 122, 0, 0, 7, 32, 0, 0, 252, 4, 0, 0, 0, 0, 156, 0, 0, 0, 0, 0, 0, 15, 0, 0, 0, 6, 0, 3, 103, 0, 0, 0, 4, 0, 0, 284, 43, 0, 0, 0, 0, 0, 0, 0, 180, 0, 0, 0, 0, 56, 4, 1, 61, 0, 0, 8, 3, 18, 0, 92, 0, 29, 309, 0, 122, 28, 0, 0, 0, 8, 0, 0, 64, 0, 0, 0, 5, 0, 0, 0, 0, 120, 0, 29, 0, 0, 0, 1, 1, 0, 1, 0, 0, 0, 33, 0, 0, 0, 7, 0, 2, 0, 0, 22, 31, 0, 329, 0, 70, 44, 0, 0, 0, 0, 0, 7, 2, 0, 1, 0, 5, 0, 1, 16, 145, 132, 10, 0, 0, 0, 0, 0, 6, 0, 1, 0, 2, 256, 0, 0, 0, 0, 42, 0, 0, 0, 2, 8, 47, 0, 0, 0, 3, 0, 4, 2, 5, 61, 6, 0, 0, 1, 0, 0, 0, 174, 52, 0, 14, 1, 0, 13, 0, 23, 5, 0, 53, 22, 53, 0, 0, 4, 0, 0, 0, 0, 0, 0, 0, 190, 1, 0, 36, 0, 3, 1, 0, 0, 0, 2, 3, 203, 0, 4, 0, 1, 0, 0, 8, 0, 41, 0, 0, 0, 0, 9, 0, 0, 224, 0, 0, 0, 1, 0, 0, 0, 4, 0, 0, 1, 18, 0, 0, 81, 3, 0, 188, 5, 0, 2, 0, 8, 0, 1, 0, 0, 0, 0, 0, 0, 277, 0, 0, 0, 236, 0, 0, 0, 39, 0, 0, 1, 70, 0, 0, 63, 1, 0, 0, 194, 0, 130, 1, 0, 0, 0, 0, 0, 430, 0, 0, 0, 0, 8, 64, 34, 0, 0, 0, 12, 1, 3, 0, 11, 59, 0, 2, 5, 0, 26, 0, 0, 1, 5, 0, 55, 27, 0, 2, 1, 9, 0, 0, 0, 7, 0, 175, 0, 0, 0, 1, 0, 0, 0, 0, 0, 2, 0, 342, 0, 0, 223, 1, 0, 0, 79, 0, 1, 0, 0, 18, 213, 1, 0, 3, 0, 0, 0, 85, 2, 0, 0, 180, 0, 10, 0, 0, 0, 409, 0, 0, 0, 0, 4, 135, 0, 0, 0, 0, 0, 487, 0, 10, 0, 2, 9, 785, 47, 0, 0, 42, 121, 2, 0, 0, 0, 0, 148, 0, 204, 0, 0, 0, 162, 13, 0, 0, 0, 0, 0, 11, 141, 85, 0, 1, 1, 0, 5, 80, 7, 10, 5, 283, 5, 0, 0, 0, 1, 0, 50, 136, 100, 1, 0, 0, 0, 0, 0, 7, 180, 2, 0, 10, 4, 77, 0, 0, 2, 0, 0, 0, 0, 0, 0, 0, 1, 0, 0, 19, 22, 0, 0, 18, 0, 0, 0, 5, 508, 0, 1, 0, 0, 0, 0, 0, 0, 0, 0, 0, 61, 79, 0, 77, 1, 0, 0, 5, 0, 0, 90, 1, 53, 51, 177, 0, 0, 0, 0, 0, 0, 0, 1, 1, 0, 0, 0, 0, 170, 51, 0, 39, 8, 75, 24, 5, 0, 0, 0, 1, 2, 0, 22, 1, 0, 0, 0, 10, 11, 0, 0, 15, 3, 0, 0, 0, 19, 0, 0, 0, 0, 3, 0, 0, 0, 2, 40, 8, 23, 172, 0, 0, 0, 0, 0, 0, 0, 56, 0, 0, 0, 58, 18, 0, 0, 0, 0, 0, 0, 0, 0, 0, 2, 23, 0, 0, 0, 0, 0, 0, 0, 2, 1, 0, 0, 163, 18, 0, 0, 82, 0, 1, 0, 0, 5, 0, 24, 0, 0, 2462, 28, 0, 182, 2, 1, 4, 0, 0, 0, 7, 19, 96, 0, 0, 1, 0, 0, 0, 0, 220, 1, 0, 0, 44, 1, 9, 136, 98, 0, 0, 0, 0, 7, 3, 0, 0, 8, 2, 0, 0, 1, 0, 1, 0, 0, 0, 0, 0, 104, 0, 0, 0, 179, 19, 130, 4, 3, 53, 5, 0, 0, 21, 31, 0, 0, 0, 8, 0, 0, 0, 0, 0, 2, 0, 71, 0, 53, 8, 0, 0, 139, 0, 0, 0, 0, 0, 84, 0, 1, 0, 267, 0, 21, 0, 20, 231, 0, 0, 0, 0, 0, 0, 0, 0, 6, 367, 0, 0, 66, 0, 0, 86, 41, 75, 12, 0, 0, 4, 25, 0, 151, 210, 3, 0, 0, 0, 19, 0, 172, 0, 0, 0, 0, 46, 0, 0, 0, 186, 20, 2, 0, 0, 8, 0, 202, 10, 0, 0, 0, 3, 0, 0, 0, 0, 1, 1, 17, 0, 0, 0, 0, 0, 326, 0, 36, 0, 1, 0, 66, 13, 0, 0, 62, 0, 0, 0, 0, 9, 0, 5, 1, 0, 0, 1, 0, 784, 105, 251, 0, 0, 0, 0, 7, 832, 0, 0, 0, 10, 0, 5, 0, 1, 0, 16, 77, 0, 0, 0, 0, 109, 0, 0, 0, 31, 0, 0, 0, 0, 0, 0, 16, 0, 40, 0, 0, 0, 0, 0, 0, 0, 0, 0, 0, 88, 0, 0, 103, 0, 5, 0, 3, 0, 0, 0, 0, 0, 0, 0, 0, 0, 0, 0, 54, 0, 0, 0, 0, 0, 0, 6, 30, 0, 76, 11, 0, 0, 6, 0, 0, 0, 39, 2, 97, 0, 0, 2, 5, 0, 0, 5, 0, 0, 144, 2, 0, 0, 0, 0, 0, 0, 0, 54, 0, 2, 0, 2, 0, 6, 0, 3, 0, 0, 0, 13, 0, 0, 20, 0, 46, 129, 0, 0, 201, 131, 0, 0, 18, 0, 0, 3, 1, 38, 2, 0, 0, 0, 1, 0, 0, 2, 1, 120, 49, 0, 6, 0, 13, 0, 1, 117, 0, 16, 0, 0, 0, 0, 0, 0, 206, 0, 27, 25, 0, 0, 9, 0, 0, 10, 0, 54, 3, 0, 0, 0, 0, 0, 119, 0, 104, 0, 0, 0, 61, 0, 0, 0, 1, 19, 3, 0, 0, 58, 2, 0, 37, 0, 2, 0, 0, 58, 174, 0, 12, 3, 95, 1, 0, 1, 8, 0, 10, 0, 0, 1, 0, 26, 0, 2, 0, 0, 51, 0, 0, 0, 0, 19, 0, 36, 10, 89, 0, 0, 0, 57, 50, 0, 50, 0, 0, 0, 0, 0, 0, 0, 4, 1, 4, 247, 39, 0
The-Long-Way-Home-A-Personal-History-of-Nova-Scotia-_Demont_-John, 0, 0, 11, 19, 2, 0, 0, 0, 0, 20, 1, 1, 0, 1, 0, 0, 0, 0, 0, 0, 0, 0, 5, 1, 0, 0, 0, 0, 43, 0, 0, 0, 0, 0, 0, 0, 0, 0, 5, 0, 3, 36, 75, 0, 0, 0, 0, 0, 0, 0, 13, 2, 0, 0, 1, 1, 5, 2, 0, 0, 20, 0, 0, 0, 1, 0, 0, 15, 0, 51, 0, 0, 0, 0, 2, 0, 0, 0, 4, 0, 0, 0, 0, 0, 0, 12, 0, 0, 0, 19, 3, 0, 7, 0, 0, 26, 0, 0, 43, 2, 0, 0, 0, 0, 0, 0, 0, 0, 1, 2, 0, 8, 0, 0, 0, 0, 0, 0, 0, 0, 3, 0, 0, 0, 6, 241, 0, 0, 0, 0, 1, 0, 1, 0, 0, 0, 25, 0, 0, 10, 0, 5, 0, 0, 0, 0, 8, 0, 0, 0, 0, 0, 11, 0, 1, 4, 5, 0, 19, 0, 0, 19, 0, 0, 0, 0, 12, 5, 6, 8, 0, 2, 0, 3, 0, 0, 0, 0, 8, 1, 0, 4, 0, 12, 0, 0, 0, 37, 21, 4, 0, 0, 11, 0, 16, 2, 0, 0, 1, 0, 0, 4, 0, 36, 0, 4, 0, 0, 12, 0, 3, 3, 9, 0, 6, 0, 0, 0, 0, 2, 0, 0, 0, 0, 6, 0, 0, 0, 0, 0, 0, 2, 0, 0, 0, 0, 9, 0, 2, 1, 0, 55, 2, 0, 0, 0, 0, 22, 0, 0, 28, 0, 0, 0, 3, 0, 21, 0, 0, 0, 0, 4, 7, 0, 0, 0, 1, 0, 0, 107, 2, 0, 16, 4, 1, 78, 0, 0, 2, 0, 40, 0, 45, 0, 12, 0, 0, 0, 0, 9, 8, 11, 12, 4, 0, 42, 0, 1, 11, 3, 5, 2, 0, 0, 0, 46, 13, 0, 0, 0, 3, 18, 0, 0, 1, 2, 0, 2, 0, 0, 1, 0, 0, 7, 0, 0, 0, 0, 42, 0, 0, 7, 0, 9, 2, 0, 55, 0, 0, 0, 6, 11, 0, 0, 0, 0, 10, 0, 0, 63, 0, 3, 1, 0, 2, 2, 0, 7, 0, 0, 2, 0, 4, 1, 0, 0, 8, 0, 4, 9, 0, 0, 0, 1, 0, 0, 13, 15, 23, 2, 0, 0, 15, 0, 0, 0, 1, 0, 5, 0, 1, 0, 0, 0, 0, 0, 0, 5, 0, 0, 0, 0, 0, 0, 46, 0, 0, 0, 0, 33, 0, 0, 0, 0, 0, 0, 137, 0, 0, 0, 0, 0, 0, 0, 0, 5, 0, 0, 11, 0, 0, 0, 0, 0, 0, 0, 0, 0, 25, 1, 0, 2, 0, 0, 97, 0, 0, 0, 0, 0, 0, 0, 1, 0, 9, 0, 26, 6, 0, 0, 0, 269, 0, 2, 0, 16, 11, 0, 0, 0, 0, 0, 0, 0, 0, 0, 0, 0, 0, 41, 0, 0, 0, 1, 0, 0, 9, 0, 1, 0, 0, 0, 0, 0, 0, 0, 5, 0, 21, 0, 0, 0, 0, 7, 0, 0, 0, 0, 0, 0, 0, 1, 3, 0, 5, 32, 0, 23, 0, 0, 0, 0, 8, 0, 0, 1, 0, 1, 0, 0, 0, 0, 0, 36, 0, 0, 0, 6, 22, 0, 6, 67, 9, 11, 0, 0, 0, 0, 0, 1, 0, 0, 11, 0, 0, 0, 1, 0, 0, 0, 2, 0, 0, 1, 0, 0, 0, 12, 0, 0, 9, 0, 0, 3, 18, 0, 0, 7, 0, 0, 2, 0, 1, 19, 0, 7, 0, 0, 1, 0, 214, 0, 3, 0, 0, 6, 0, 13, 18, 32, 0, 0, 0, 19, 0, 0, 0, 0, 20, 15, 44, 0, 79, 0, 14, 0, 0, 12, 71, 0, 0, 0, 9, 0, 23, 3, 0, 6, 2, 28, 0, 56, 0, 11, 0, 0, 6, 0, 0, 1, 0, 9, 0, 0, 12, 0, 32, 1, 0, 0, 0, 0, 1, 0, 0, 10, 16, 2, 1, 0, 0, 0, 4, 0, 0, 0, 24, 0, 4, 0, 1, 0, 0, 0, 0, 4, 0, 0, 0, 0, 0, 23, 0, 0, 5, 0, 0, 0, 4, 1, 1, 5, 0, 0, 1, 1, 0, 0, 0, 0, 2, 0, 0, 0, 0, 0, 6, 11, 0, 0, 0, 8, 0, 0, 9, 0, 7, 20, 0, 0, 0, 0, 0, 6, 0, 11, 0, 9, 9, 8, 0, 0, 0, 20, 0, 0, 0, 0, 16, 27, 0, 0, 0, 0, 0, 1, 0, 0, 0, 2, 0, 38, 39, 0, 0, 0, 4, 0, 0, 0, 6, 0, 0, 0, 0, 0, 2, 0, 2, 0, 0, 0, 0, 14, 1, 7, 0, 0, 0, 5, 2, 2, 0, 5, 0, 29, 1, 0, 9, 0, 0, 0, 0, 7, 0, 0, 15, 0, 0, 0, 0, 0, 0, 0, 0, 0, 0, 38, 0, 0, 0, 11, 0, 6, 0, 0, 9, 0, 2, 0, 0, 0, 113, 0, 0, 16, 0, 1, 3, 0, 6, 0, 4, 1, 2, 0, 0, 0, 0, 3, 0, 0, 0, 0, 8, 0, 7, 2, 4, 5, 59, 0, 0, 0, 0, 0, 17, 0, 1, 5, 0, 0, 0, 0, 0, 0, 1, 0, 0, 0, 4, 19, 27, 3, 0, 0, 9, 15, 1, 13, 6, 3, 9, 0, 0, 0, 4, 0, 30, 190, 1, 0, 4, 0, 0, 68, 0, 7, 0, 0, 2, 12, 4, 0, 0, 11, 0, 0, 0, 2, 0, 0, 0, 32, 0, 13, 0, 0, 3, 0, 0, 0, 0, 0, 0, 1, 4, 100, 0, 3, 0, 0, 64, 1, 9, 0, 0, 2, 2, 0, 0, 1, 3, 0, 0, 0, 0, 98, 0, 0, 4, 0, 80, 0, 1, 0, 0, 13, 40, 0, 27, 0, 0, 59, 0, 19, 0, 0, 0, 0, 0, 1, 0, 0, 12, 0, 0, 0, 8, 0, 0, 0, 3, 0, 0, 0, 8, 0, 0, 66, 0, 0, 0, 10, 0, 6, 0, 14, 0, 0, 0, 0, 0, 0, 0, 0, 3, 45, 4, 0, 0, 0, 0, 0, 0, 18, 0, 1, 1, 0, 4, 1, 0, 62, 0, 0, 0, 1, 0, 12, 79, 0, 0, 0, 4, 0, 0, 1, 0, 0, 10, 0, 0, 0, 1, 20, 0, 1, 0, 0, 12, 0, 8, 0, 0, 0, 3, 6, 0, 10, 0, 0, 0, 0, 0, 4, 0, 2, 22, 0, 0, 0, 9, 23, 0, 0, 3, 0, 32, 0, 0, 0, 3, 0, 0, 0, 0, 0, 3, 0, 0, 0, 20, 0, 8, 0, 2, 0, 0, 69, 9, 0, 0, 0, 20, 6, 0, 0, 0, 0, 0, 12, 0, 19, 0, 0, 0, 4, 17, 0, 0, 0, 0, 0, 1, 2, 16, 0, 6, 1, 0, 6, 2, 1, 8, 0, 0, 0, 0, 0, 0, 0, 0, 25, 2, 6, 2, 0, 0, 0, 0, 0, 4, 9, 0, 0, 0, 0, 2, 100, 0, 0, 0, 0, 0, 6, 0, 0, 0, 4, 0, 0, 0, 8, 0, 0, 0, 0, 0, 0, 5, 1, 0, 1, 0, 0, 0, 0, 0, 0, 0, 8, 0, 1, 0, 0, 0, 61, 0, 0, 23, 0, 0, 8, 0, 1, 1, 8, 0, 0, 0, 0, 0, 0, 0, 0, 1, 0, 0, 0, 0, 4, 1, 0, 62, 0, 5, 29, 0, 0, 0, 0, 4, 6, 0, 52, 4, 0, 0, 0, 3, 11, 0, 0, 68, 6, 0, 0, 5, 0, 0, 3, 0, 0, 1, 0, 0, 0, 0, 24, 0, 3, 1, 0, 0, 0, 0, 0, 0, 4, 81, 0, 0, 11, 3, 3, 0, 0, 0, 0, 1, 0, 0, 0, 0, 0, 11, 0, 0, 0, 0, 0, 0, 0, 2, 0, 1, 0, 46, 1, 0, 0, 2, 0, 2, 0, 0, 2, 0, 0, 0, 4, 18, 0, 0, 52, 6, 0, 4, 6, 2, 0, 5, 0, 35, 0, 0, 0, 0, 1, 0, 0, 4, 0, 0, 0, 6, 38, 45, 52, 0, 0, 0, 0, 0, 30, 0, 0, 0, 0, 0, 0, 0, 0, 0, 0, 2, 0, 1, 0, 0, 9, 0, 0, 1, 7, 31, 59, 1, 0, 13, 6, 0, 0, 9, 0, 0, 0, 0, 0, 0, 0, 0, 0, 0, 33, 0, 4, 0, 1, 10, 0, 0, 2, 0, 0, 0, 5, 1, 21, 15, 57, 0, 1, 0, 63, 0, 13, 24, 0, 0, 0, 0, 0, 0, 7, 0, 10, 0, 0, 0, 5, 1, 0, 6, 4, 0, 15, 0, 0, 0, 9, 0, 33, 0, 0, 0, 0, 0, 2, 0, 0, 3, 0, 0, 0, 1, 0, 5, 0, 0, 13, 27, 0, 0, 19, 0, 5, 9, 0, 0, 0, 9, 0, 0, 0, 0, 5, 0, 1, 17, 0, 0, 0, 0, 2, 0, 3, 0, 0, 0, 18, 43, 21, 0, 1, 0, 0, 4, 0, 24, 0, 141, 8, 0, 0, 0, 0, 24, 0, 3, 0, 0, 0, 0, 0, 2, 0, 0, 0, 0, 0, 0, 0, 6, 0, 3, 0, 0, 0, 0, 11, 5, 0, 0, 0, 4, 0, 0, 0, 75, 0, 0, 41, 0, 17, 0, 0, 0, 0, 69, 0, 0, 0, 0, 0, 0, 0, 0, 1, 14, 3, 0, 0, 0, 0, 0, 0, 0, 0, 0, 0, 22, 0, 1, 26, 1, 0, 0, 0, 0, 0, 8, 14, 0, 18, 5, 0, 0, 17, 0, 0, 0, 8, 1, 36, 0, 0, 15, 9, 0, 0, 1, 0, 0, 3, 2, 0, 0, 0, 0, 0, 0, 0, 0, 0, 0, 19, 0, 0, 4, 4, 0, 31, 0, 0, 21, 0, 0, 41, 5, 3, 31, 0, 16, 4, 61, 0, 0, 0, 0, 0, 5, 0, 20, 3, 0, 0, 0, 0, 0, 9, 1, 0, 21, 18, 0, 0, 3, 27, 0, 0, 24, 1, 1, 0, 0, 7, 0, 0, 0, 4, 1, 24, 17, 0, 0, 19, 0, 5, 78, 0, 0, 0, 0, 0, 0, 0, 0, 7, 0, 11, 0, 0, 0, 2, 0, 0, 0, 0, 0, 36, 0, 0, 2, 0, 0, 1, 0, 0, 1, 0, 2, 31, 0, 9, 0, 3, 1, 0, 1, 5, 0, 0, 0, 0, 9, 0, 12, 1, 4, 0, 0, 1, 0, 0, 0, 0, 4, 0, 0, 2, 36, 0, 0, 0, 1, 71, 3, 14, 0, 0, 0, 0, 0, 0, 0, 1, 1, 2, 67, 90, 0
Titan-The-Life-of-John-D.-Rockefeller_-Sr.-by-Ron-Chernow-_z-lib.org_, 0, 0, 0, 142, 62, 0, 0, 0, 0, 82, 0, 47, 12, 0, 0, 0, 1, 0, 0, 0, 0, 0, 0, 21, 0, 0, 0, 2, 9, 0, 0, 0, 1, 0, 0, 0, 0, 2, 81, 0, 41, 1, 141, 0, 0, 0, 0, 3, 0, 0, 0, 61, 0, 0, 0, 2, 0, 0, 0, 0, 265, 3, 0, 0, 70, 0, 0, 60, 0, 13, 0, 0, 0, 0, 12, 2, 0, 0, 323, 0, 1, 0, 0, 0, 0, 94, 0, 0, 0, 158, 1, 0, 12, 3, 0, 0, 0, 0, 9, 8, 6, 0, 0, 0, 0, 0, 3, 0, 27, 0, 0, 42, 0, 0, 0, 77, 0, 23, 1, 0, 6, 3, 9, 0, 44, 434, 1, 0, 1, 0, 23, 0, 0, 0, 0, 0, 10, 0, 0, 7, 0, 0, 0, 0, 0, 17, 135, 0, 1, 0, 0, 0, 3, 0, 17, 8, 8, 0, 126, 9, 1, 160, 0, 0, 71, 0, 47, 7, 40, 51, 0, 1, 0, 60, 1, 0, 22, 0, 43, 8, 0, 33, 0, 98, 0, 0, 0, 42, 0, 4, 0, 0, 9, 16, 56, 8, 0, 0, 10, 0, 0, 15, 1, 109, 1, 3, 2, 1, 23, 10, 29, 53, 7, 0, 57, 0, 1, 0, 0, 31, 0, 0, 0, 0, 12, 0, 0, 0, 6, 1, 0, 6, 0, 0, 0, 0, 22, 0, 2, 0, 0, 38, 3, 0, 1, 0, 0, 0, 17, 0, 91, 0, 0, 0, 203, 0, 116, 2, 0, 0, 0, 29, 28, 0, 0, 0, 2, 1, 0, 59, 7, 0, 54, 1, 44, 50, 2, 1, 4, 0, 85, 0, 0, 0, 38, 0, 167, 0, 22, 42, 3, 51, 12, 1, 1, 54, 0, 59, 7, 24, 3, 8, 11, 0, 0, 134, 60, 0, 0, 0, 30, 0, 0, 0, 0, 19, 2, 4, 0, 2, 13, 0, 0, 31, 0, 0, 0, 0, 131, 0, 0, 29, 0, 83, 18, 0, 0, 1, 0, 0, 2, 0, 0, 0, 0, 0, 69, 1, 0, 8, 0, 41, 5, 0, 21, 0, 0, 124, 0, 0, 24, 0, 426, 1, 0, 0, 56, 0, 55, 8, 0, 0, 8, 3, 0, 0, 57, 107, 11, 39, 0, 73, 77, 0, 0, 21, 0, 0, 48, 0, 38, 12, 0, 0, 0, 0, 0, 3, 0, 0, 0, 0, 0, 0, 0, 0, 0, 0, 6, 294, 12, 0, 0, 0, 14, 5, 3, 1, 0, 0, 0, 0, 1, 0, 0, 4, 0, 0, 75, 0, 0, 0, 0, 5, 2, 0, 0, 1, 269, 5, 0, 6, 0, 1, 381, 0, 0, 0, 124, 0, 0, 0, 0, 0, 0, 0, 139, 21, 4, 0, 0, 609, 0, 17, 15, 0, 41, 0, 0, 0, 0, 0, 0, 0, 0, 0, 0, 0, 2, 84, 65, 0, 5, 0, 0, 0, 54, 0, 5, 0, 0, 0, 0, 0, 0, 0, 27, 1, 52, 16, 0, 0, 0, 50, 0, 0, 0, 0, 0, 0, 0, 5, 0, 0, 69, 160, 0, 16, 0, 0, 0, 0, 41, 0, 0, 72, 0, 8, 1, 13, 8, 3, 0, 0, 0, 2, 2, 91, 0, 0, 37, 17, 1, 13, 4, 0, 0, 1, 0, 3, 0, 0, 49, 0, 0, 0, 42, 0, 0, 19, 0, 0, 0, 2, 0, 0, 0, 17, 0, 0, 63, 3, 0, 9, 0, 0, 3, 85, 0, 1, 2, 0, 0, 0, 0, 795, 0, 0, 0, 0, 0, 0, 54, 0, 0, 15, 0, 48, 7, 292, 0, 0, 0, 124, 0, 0, 0, 0, 61, 13, 126, 0, 197, 0, 14, 0, 0, 34, 17, 0, 0, 1, 6, 0, 83, 2, 0, 32, 25, 61, 0, 96, 0, 53, 0, 0, 207, 0, 0, 0, 0, 58, 0, 0, 84, 0, 138, 0, 0, 0, 0, 0, 47, 0, 0, 7, 0, 112, 0, 0, 0, 1, 26, 0, 0, 0, 65, 0, 16, 0, 0, 175, 0, 0, 1, 42, 1, 0, 0, 0, 0, 43, 0, 0, 52, 0, 8, 0, 14, 14, 0, 32, 0, 0, 3, 5, 0, 0, 0, 1, 26, 1, 0, 0, 260, 0, 31, 99, 0, 0, 0, 169, 0, 0, 106, 0, 95, 17, 0, 0, 0, 4, 1, 0, 0, 73, 0, 10, 0, 17, 0, 0, 21, 54, 0, 0, 0, 0, 4, 0, 0, 0, 4, 0, 25, 43, 16, 0, 0, 20, 0, 21, 84, 0, 0, 0, 0, 0, 0, 0, 17, 0, 0, 0, 0, 1, 0, 0, 14, 0, 0, 0, 0, 35, 1, 4, 47, 0, 0, 88, 13, 224, 0, 12, 110, 128, 12, 0, 25, 41, 0, 0, 0, 17, 0, 0, 171, 0, 0, 0, 0, 1, 0, 0, 0, 0, 0, 32, 0, 0, 0, 25, 0, 99, 1, 0, 0, 0, 8, 0, 0, 0, 100, 0, 4, 0, 0, 7, 18, 0, 91, 0, 20, 12, 2, 0, 95, 0, 2, 7, 0, 0, 0, 0, 27, 0, 6, 34, 14, 1266, 41, 0, 17, 0, 0, 0, 188, 226, 15, 1, 0, 13, 0, 0, 0, 1, 6, 0, 0, 0, 0, 33, 15, 3, 0, 0, 45, 48, 4, 54, 3, 75, 9, 0, 0, 0, 391, 0, 5, 328, 74, 0, 12, 7, 0, 100, 0, 43, 2, 0, 9, 132, 18, 0, 0, 31, 0, 0, 0, 0, 0, 0, 0, 94, 0, 0, 0, 0, 65, 0, 0, 0, 0, 0, 2, 26, 1, 1, 0, 23, 0, 24, 18, 1, 83, 0, 0, 10, 7, 0, 0, 1, 25, 0, 0, 7, 0, 0, 0, 0, 6, 0, 0, 0, 0, 0, 0, 177, 22, 0, 111, 7, 0, 44, 0, 44, 0, 7, 3, 0, 0, 6, 0, 0, 18, 0, 0, 0, 45, 0, 0, 0, 28, 0, 0, 4, 135, 0, 0, 162, 0, 0, 40, 152, 0, 41, 0, 0, 0, 0, 0, 179, 0, 0, 0, 0, 20, 110, 42, 9, 0, 0, 0, 9, 20, 29, 0, 1, 7, 2, 10, 0, 0, 317, 0, 3, 0, 6, 0, 96, 28, 0, 0, 0, 15, 0, 0, 0, 3, 0, 81, 0, 0, 0, 4, 0, 130, 0, 0, 0, 24, 0, 72, 1, 0, 42, 0, 0, 0, 9, 0, 1, 0, 6, 5, 30, 4, 1, 6, 0, 0, 0, 82, 17, 0, 0, 32, 0, 92, 0, 0, 0, 13, 0, 0, 0, 0, 0, 115, 0, 0, 0, 0, 0, 49, 0, 0, 0, 2, 25, 140, 32, 0, 1, 123, 37, 2, 0, 0, 4096, 0, 143, 0, 173, 0, 0, 0, 149, 139, 0, 0, 0, 0, 0, 1, 13, 113, 0, 3, 1, 0, 8, 31, 9, 14, 1, 89, 0, 0, 0, 0, 1, 0, 103, 33, 24, 3, 0, 0, 0, 0, 0, 14, 30, 0, 0, 0, 5, 36, 0, 0, 1, 0, 0, 0, 219, 0, 0, 0, 2, 0, 2, 17, 40, 0, 0, 0, 0, 0, 0, 14, 36, 0, 2, 4, 0, 0, 0, 0, 0, 0, 10, 0, 16, 0, 0, 4, 36, 0, 0, 17, 0, 0, 17, 0, 23, 20, 132, 1, 0, 0, 0, 0, 0, 0, 0, 0, 0, 0, 0, 0, 55, 11, 0, 121, 6, 36, 4, 3, 0, 0, 0, 6, 109, 0, 106, 13, 0, 0, 0, 17, 13, 0, 0, 58, 30, 0, 0, 4, 4, 0, 0, 0, 0, 24, 0, 0, 0, 1, 17, 3, 52, 47, 0, 0, 0, 0, 0, 0, 0, 118, 0, 0, 0, 123, 25, 0, 0, 0, 0, 2, 0, 0, 6, 0, 4, 1809, 0, 0, 0, 1, 0, 0, 0, 41, 1, 0, 0, 458, 3, 0, 0, 25, 0, 0, 0, 0, 9, 0, 118, 1, 1, 125, 0, 0, 343, 5, 0, 3, 1, 1, 0, 6, 0, 124, 0, 0, 0, 0, 1, 0, 0, 138, 1, 0, 0, 73, 14, 48, 140, 52, 0, 0, 0, 0, 0, 0, 0, 0, 24, 0, 0, 0, 4, 0, 0, 7, 0, 0, 0, 0, 57, 0, 0, 9, 112, 160, 880, 0, 0, 29, 28, 0, 0, 33, 5, 0, 0, 0, 0, 0, 0, 0, 1, 0, 239, 0, 68, 0, 14, 3, 0, 0, 20, 0, 0, 0, 23, 1, 30, 0, 524, 0, 22, 0, 16, 0, 55, 92, 0, 0, 205, 0, 0, 1, 1, 0, 20, 76, 0, 1, 28, 0, 0, 48, 43, 45, 91, 0, 0, 2, 39, 2, 124, 0, 3, 0, 0, 0, 11, 0, 11, 3, 0, 0, 0, 2, 0, 0, 0, 11, 79, 2, 0, 0, 77, 0, 75, 8, 0, 0, 0, 7, 0, 0, 0, 0, 9, 7, 0, 29, 0, 0, 173, 2, 13, 0, 15, 0, 2, 10, 34, 70, 0, 0, 8, 0, 0, 0, 1, 103, 0, 62, 1, 0, 0, 10, 0, 640, 20, 4, 0, 0, 0, 0, 0, 9, 0, 0, 0, 1, 163, 9, 0, 21, 0, 50, 0, 0, 0, 0, 0, 23, 4, 0, 0, 31, 0, 0, 0, 1, 2, 0, 12, 1, 23, 339, 0, 0, 14, 0, 0, 1, 0, 0, 0, 62, 0, 0, 8, 38, 8, 0, 0, 0, 1, 0, 40, 0, 0, 3, 0, 1, 0, 0, 67, 0, 0, 0, 0, 0, 4, 1, 0, 0, 92, 86, 2, 72, 173, 0, 0, 0, 76, 57, 99, 0, 0, 7, 6, 0, 0, 16, 0, 0, 43, 4, 0, 0, 0, 0, 0, 0, 0, 60, 0, 0, 0, 8, 0, 13, 11, 15, 6, 1, 0, 338, 5, 0, 19, 14, 8, 464, 0, 1, 76, 121, 0, 0, 0, 0, 0, 22, 6, 32, 10, 0, 0, 1, 2, 0, 18, 0, 0, 76, 108, 0, 0, 3, 78, 0, 0, 165, 153, 5, 0, 0, 0, 0, 0, 6, 52, 11, 84, 76, 3, 0, 0, 0, 4, 8, 0, 11, 0, 0, 0, 5, 0, 0, 62, 0, 87, 0, 0, 0, 61, 0, 0, 0, 0, 10, 306, 0, 0, 24, 9, 0, 6, 1, 0, 0, 0, 90, 57, 0, 27, 0, 38, 2, 0, 6, 3, 0, 4, 0, 0, 9, 1, 55, 0, 59, 0, 0, 2, 1, 0, 0, 0, 23, 0, 0, 18, 207, 0, 0, 0, 1, 288, 80, 59, 0, 0, 0, 0, 0, 0, 0, 17, 2, 36, 111, 53, 0
Tough calls ATT and the hard lessons learned from the telecom wars by Dick Martin (z-lib.org), 0, 0, 0, 38, 130, 0, 0, 0, 0, 12, 0, 24, 0, 0, 0, 45, 6, 1, 0, 0, 0, 0, 0, 85, 12, 0, 0, 0, 2, 7, 0, 0, 0, 0, 0, 0, 0, 1, 125, 0, 25, 0, 15, 0, 0, 0, 0, 46, 0, 0, 0, 59, 0, 0, 0, 0, 0, 0, 0, 0, 110, 0, 1, 0, 4, 0, 0, 20, 0, 2, 0, 0, 0, 0, 0, 0, 0, 0, 26, 0, 0, 0, 0, 0, 0, 1, 0, 0, 0, 42, 0, 0, 7, 0, 0, 0, 0, 0, 0, 0, 2, 1, 0, 0, 73, 0, 0, 5, 3, 0, 0, 25, 0, 0, 0, 21, 0, 0, 0, 0, 0, 0, 0, 0, 1, 211, 0, 0, 0, 0, 3, 0, 0, 0, 0, 0, 0, 0, 0, 0, 0, 0, 0, 0, 0, 15, 115, 0, 0, 0, 1, 0, 0, 0, 32, 26, 3, 0, 40, 4, 1, 39, 0, 0, 3, 0, 13, 1, 13, 0, 0, 0, 0, 26, 13, 0, 0, 0, 32, 57, 0, 16, 0, 6, 0, 0, 0, 5, 0, 82, 0, 0, 1, 2, 23, 0, 0, 13, 33, 0, 0, 6, 0, 55, 0, 0, 1, 0, 4, 3, 11, 15, 5, 0, 0, 0, 0, 0, 0, 14, 0, 0, 0, 0, 0, 0, 0, 0, 0, 0, 1, 0, 0, 0, 0, 0, 7, 0, 0, 0, 0, 3, 0, 2, 1, 0, 0, 0, 0, 0, 28, 0, 0, 0, 135, 0, 40, 0, 0, 0, 0, 6, 8, 6, 0, 0, 3, 0, 0, 9, 2, 0, 10, 0, 11, 11, 3, 0, 0, 0, 11, 0, 0, 0, 3, 0, 0, 0, 0, 6, 1, 22, 2, 0, 0, 1, 0, 15, 0, 4, 0, 20, 0, 0, 0, 30, 28, 0, 0, 21, 15, 0, 0, 0, 0, 27, 0, 12, 0, 0, 4, 0, 0, 19, 0, 0, 0, 0, 12, 0, 0, 6, 0, 6, 0, 0, 0, 0, 0, 0, 5, 0, 0, 0, 0, 0, 60, 2, 0, 4, 0, 1, 1, 0, 38, 0, 0, 176, 0, 0, 17, 0, 2, 0, 0, 0, 6, 0, 29, 1, 0, 1, 4, 3, 0, 0, 16, 78, 2, 20, 0, 0, 0, 0, 0, 27, 0, 0, 9, 0, 26, 13, 0, 0, 0, 18, 0, 0, 0, 0, 0, 0, 0, 0, 0, 0, 0, 23, 0, 65, 0, 1, 0, 0, 12, 0, 0, 0, 0, 0, 0, 0, 0, 0, 0, 4, 0, 0, 45, 0, 0, 8, 0, 1, 0, 0, 1, 0, 12, 0, 12, 16, 0, 3, 23, 0, 0, 0, 0, 0, 26, 1, 0, 2, 12, 0, 68, 16, 0, 0, 0, 292, 1, 3, 3, 0, 37, 0, 0, 0, 0, 0, 0, 0, 0, 0, 0, 0, 0, 11, 0, 0, 4, 0, 0, 0, 0, 0, 2, 0, 0, 43, 0, 1, 0, 0, 6, 0, 4, 6, 0, 1, 0, 14, 0, 0, 0, 0, 0, 0, 0, 1, 0, 0, 48, 55, 0, 6, 0, 1, 0, 0, 17, 0, 0, 24, 0, 0, 19, 15, 13, 0, 0, 0, 0, 0, 0, 12, 0, 0, 0, 2, 0, 2, 0, 0, 0, 0, 0, 0, 0, 0, 1, 0, 0, 0, 71, 0, 8, 17, 46, 0, 0, 0, 0, 0, 0, 0, 0, 0, 27, 2, 0, 4, 0, 1, 0, 85, 0, 0, 3, 0, 0, 0, 57, 1, 77, 0, 29, 0, 1, 29, 4, 0, 0, 4, 0, 1, 0, 7, 0, 0, 1, 24, 0, 0, 0, 0, 1, 5, 13, 0, 72, 0, 9, 0, 0, 9, 2, 0, 0, 3, 0, 0, 62, 0, 0, 24, 4, 4, 4, 20, 0, 4, 21, 0, 112, 0, 0, 33, 0, 38, 0, 0, 12, 0, 24, 0, 0, 0, 0, 0, 21, 0, 2, 1, 0, 0, 0, 21, 0, 0, 24, 0, 1, 0, 1, 0, 2, 0, 0, 0, 0, 0, 0, 27, 5, 1, 0, 0, 0, 94, 0, 0, 21, 4, 5, 0, 9, 1, 0, 11, 0, 0, 0, 6, 24, 0, 0, 1, 107, 2, 1, 0, 0, 0, 41, 8, 0, 0, 0, 57, 0, 0, 33, 26, 51, 0, 0, 0, 0, 0, 0, 0, 0, 16, 0, 2, 0, 46, 64, 0, 13, 15, 0, 0, 0, 0, 0, 0, 0, 0, 0, 0, 0, 13, 0, 0, 0, 29, 0, 2, 37, 0, 0, 0, 0, 0, 0, 0, 50, 0, 0, 0, 0, 0, 0, 0, 26, 0, 0, 0, 0, 154, 0, 0, 25, 0, 0, 8, 14, 2, 0, 2, 1, 21, 0, 0, 30, 3, 0, 0, 0, 28, 0, 0, 79, 0, 0, 0, 0, 37, 0, 2, 0, 1, 0, 16, 0, 0, 0, 2, 0, 2, 0, 0, 0, 0, 61, 0, 0, 0, 12, 0, 0, 0, 0, 0, 9, 0, 0, 0, 2, 53, 0, 1, 0, 0, 0, 0, 0, 0, 1, 0, 0, 0, 2, 7, 52, 14, 4, 0, 2, 0, 34, 0, 9, 0, 0, 0, 0, 29, 0, 0, 0, 1, 3, 0, 2, 0, 0, 26, 1, 0, 0, 1, 3, 6, 0, 2, 2, 6, 0, 0, 0, 0, 5, 0, 1, 219, 26, 0, 1, 0, 0, 19, 0, 8, 2, 0, 0, 4, 10, 3, 0, 146, 0, 0, 0, 0, 0, 2, 0, 5, 0, 0, 0, 0, 0, 0, 0, 0, 0, 0, 0, 8, 0, 0, 0, 0, 0, 0, 2, 0, 21, 0, 0, 0, 1, 16, 0, 0, 29, 0, 0, 0, 0, 0, 0, 0, 113, 0, 0, 0, 3, 13, 0, 11, 1, 0, 88, 0, 0, 3, 0, 3, 0, 9, 0, 0, 0, 2, 27, 0, 3, 0, 0, 0, 16, 0, 0, 0, 38, 0, 1, 0, 41, 0, 0, 55, 0, 0, 0, 108, 0, 5, 0, 0, 95, 0, 0, 0, 0, 0, 0, 0, 3, 6, 16, 0, 0, 0, 0, 9, 0, 3, 0, 9, 11, 58, 0, 0, 0, 33, 0, 0, 0, 0, 0, 45, 0, 0, 0, 0, 3, 0, 0, 0, 0, 0, 43, 0, 0, 0, 0, 0, 0, 78, 0, 0, 3, 0, 209, 0, 0, 3, 0, 0, 0, 11, 0, 0, 0, 3, 1, 6, 1, 451, 0, 0, 0, 0, 40, 1, 0, 0, 58, 0, 9, 0, 0, 0, 1, 0, 0, 0, 0, 0, 12, 0, 0, 0, 0, 0, 5, 0, 18, 0, 0, 1, 71, 12, 0, 1, 32, 20, 2, 0, 0, 1, 0, 54, 0, 0, 0, 0, 0, 49, 21, 0, 0, 0, 0, 0, 0, 0, 97, 0, 0, 0, 0, 0, 12, 2, 9, 0, 111, 5, 0, 0, 0, 6, 0, 24, 56, 29, 0, 0, 0, 16, 0, 90, 8, 42, 2, 0, 0, 0, 4, 0, 1, 1, 0, 0, 0, 1, 0, 21, 0, 0, 0, 0, 0, 6, 0, 0, 0, 0, 0, 0, 0, 40, 0, 2, 0, 0, 0, 0, 0, 0, 0, 0, 1, 14, 0, 0, 74, 0, 0, 0, 11, 9, 0, 15, 0, 0, 19, 120, 1, 0, 0, 0, 0, 0, 0, 0, 0, 0, 0, 0, 0, 25, 118, 0, 79, 53, 30, 1, 0, 0, 0, 0, 0, 16, 0, 10, 1, 0, 0, 0, 5, 0, 0, 0, 14, 0, 100, 0, 1, 3, 0, 1, 0, 0, 2, 3, 0, 0, 1, 1, 0, 4, 10, 0, 0, 2, 0, 0, 0, 0, 174, 2, 47, 0, 3, 34, 0, 0, 0, 0, 2, 4, 0, 1, 0, 1, 3, 0, 0, 0, 0, 0, 0, 0, 3, 0, 0, 42, 772, 56, 0, 0, 32, 0, 0, 0, 4, 4, 0, 5, 0, 0, 17, 2, 0, 82, 3, 0, 0, 0, 0, 0, 169, 0, 22, 0, 0, 0, 0, 1, 0, 0, 55, 0, 0, 0, 39, 0, 11, 36, 10, 0, 0, 0, 0, 0, 0, 0, 0, 231, 8, 0, 0, 3, 0, 1, 0, 0, 0, 0, 0, 3, 0, 0, 13, 127, 7, 94, 0, 0, 17, 8, 71, 0, 31, 70, 0, 0, 0, 5, 0, 0, 25, 0, 0, 3, 0, 18, 0, 3, 7, 0, 0, 5, 0, 0, 0, 2, 0, 3, 1, 11, 28, 10, 0, 0, 0, 2, 60, 0, 0, 0, 0, 0, 0, 0, 36, 0, 39, 3, 0, 16, 0, 0, 10, 8, 0, 9, 0, 0, 1, 2, 0, 83, 0, 0, 0, 1, 0, 2, 16, 17, 0, 0, 0, 0, 85, 0, 0, 0, 64, 2, 7, 0, 0, 15, 0, 39, 0, 0, 0, 0, 0, 0, 0, 0, 0, 1, 0, 0, 2, 0, 0, 0, 0, 12, 1, 25, 0, 0, 2, 3, 1, 0, 0, 1, 0, 0, 0, 0, 6, 1, 7, 0, 0, 0, 2, 0, 270, 95, 1, 0, 0, 0, 0, 4, 3, 0, 2, 39, 0, 1, 3, 0, 0, 0, 6, 0, 0, 4, 0, 0, 8, 31, 3, 0, 6, 0, 0, 0, 0, 0, 0, 0, 0, 34, 0, 0, 0, 13, 0, 0, 0, 0, 0, 0, 10, 0, 0, 0, 3, 3, 0, 0, 0, 0, 34, 0, 0, 0, 4, 28, 0, 0, 0, 2, 0, 0, 0, 0, 0, 0, 1, 0, 0, 16, 0, 0, 0, 16, 0, 0, 0, 20, 30, 28, 0, 0, 0, 0, 7, 0, 0, 0, 0, 19, 0, 0, 0, 0, 0, 0, 0, 0, 38, 0, 8, 0, 0, 0, 72, 1, 8, 0, 0, 96, 4, 23, 0, 0, 2, 0, 25, 0, 0, 67, 24, 0, 0, 5, 0, 0, 0, 1, 46, 1, 0, 0, 0, 265, 0, 0, 4, 0, 20, 20, 0, 0, 0, 11, 0, 0, 52, 0, 79, 0, 0, 0, 21, 0, 0, 52, 0, 74, 31, 4, 0, 0, 0, 1, 4, 0, 8, 0, 0, 0, 0, 0, 1, 27, 0, 17, 0, 0, 0, 10, 0, 0, 0, 0, 7, 5, 0, 0, 0, 0, 0, 153, 0, 0, 0, 0, 28, 108, 50, 3, 0, 3, 12, 0, 1, 0, 0, 75, 0, 0, 0, 1, 14, 0, 4, 0, 0, 5, 0, 0, 0, 0, 5, 0, 0, 8, 24, 0, 0, 0, 8, 17, 0, 26, 0, 0, 0, 0, 0, 0, 0, 1, 0, 24, 39, 3, 0
Ugly-Beauty-Helena-Rubinstein_-LOréal_-and-the-Blemished-History-of-Looking-Good-by-Ruth-Brandon-_z-, 0, 0, 0, 17, 9, 0, 0, 0, 0, 21, 0, 2, 6, 0, 0, 0, 0, 1, 0, 0, 0, 0, 0, 8, 0, 0, 0, 0, 1, 1, 0, 0, 0, 0, 0, 0, 0, 0, 17, 0, 5, 0, 110, 0, 0, 0, 0, 4, 1, 0, 0, 19, 0, 0, 0, 3, 0, 0, 0, 0, 45, 0, 0, 0, 4, 0, 0, 13, 0, 6, 0, 0, 0, 0, 2, 0, 0, 0, 5, 320, 0, 0, 0, 0, 0, 5, 0, 4, 0, 49, 0, 0, 2, 0, 0, 0, 0, 4, 0, 2, 0, 0, 0, 0, 0, 0, 0, 0, 4, 0, 0, 8, 0, 0, 0, 14, 0, 0, 3, 0, 0, 0, 0, 0, 14, 103, 0, 0, 18, 0, 0, 0, 0, 0, 0, 0, 0, 0, 0, 5, 0, 1, 0, 0, 0, 1, 13, 0, 0, 0, 0, 0, 1, 0, 4, 1, 0, 36, 10, 0, 0, 18, 0, 0, 0, 0, 5, 1, 13, 24, 0, 0, 0, 5, 0, 0, 3, 0, 5, 2, 0, 12, 0, 63, 0, 0, 0, 17, 0, 7, 0, 0, 4, 7, 4, 0, 203, 0, 1, 0, 0, 0, 0, 35, 0, 1, 3, 1, 5, 5, 12, 6, 5, 0, 8, 0, 0, 0, 0, 2, 26, 0, 0, 0, 21, 0, 0, 0, 64, 0, 0, 3, 0, 0, 0, 0, 6, 0, 0, 0, 1, 2, 0, 0, 0, 0, 0, 0, 0, 0, 7, 0, 0, 0, 10, 0, 20, 1, 0, 0, 0, 3, 5, 0, 0, 0, 1, 0, 0, 8, 1, 0, 3, 0, 2, 8, 0, 0, 0, 0, 21, 0, 0, 0, 8, 0, 0, 0, 1, 26, 1, 20, 0, 0, 0, 1, 0, 18, 3, 11, 0, 1, 0, 0, 0, 19, 29, 0, 0, 3, 11, 0, 0, 0, 0, 0, 0, 4, 0, 97, 0, 0, 0, 13, 0, 0, 0, 0, 41, 0, 0, 7, 0, 11, 10, 0, 0, 1, 0, 0, 4, 0, 0, 0, 0, 0, 11, 2, 0, 18, 12, 0, 6, 0, 6, 0, 1, 19, 0, 0, 8, 0, 1, 0, 0, 0, 4, 0, 6, 0, 0, 0, 0, 0, 0, 1, 25, 4, 0, 33, 0, 0, 9, 0, 0, 2, 1, 0, 2, 0, 3, 7, 0, 0, 0, 0, 1, 0, 0, 0, 0, 0, 0, 0, 0, 0, 0, 0, 1, 51, 1, 0, 0, 0, 2, 0, 0, 0, 0, 0, 0, 0, 0, 0, 0, 1, 0, 0, 41, 0, 0, 0, 0, 4, 0, 0, 0, 48, 15, 4, 0, 7, 0, 0, 164, 0, 0, 0, 0, 0, 0, 1, 0, 0, 3, 0, 38, 9, 0, 0, 0, 169, 0, 91, 7, 0, 12, 0, 0, 0, 0, 0, 0, 0, 0, 0, 0, 0, 1, 33, 0, 0, 1, 21, 0, 0, 10, 0, 1, 0, 0, 0, 0, 0, 0, 0, 23, 1, 1, 16, 0, 0, 0, 12, 0, 0, 0, 0, 0, 0, 0, 0, 23, 0, 18, 17, 0, 1, 0, 1, 0, 0, 6, 0, 0, 19, 0, 0, 0, 0, 1, 0, 0, 0, 0, 0, 15, 39, 0, 0, 9, 98, 117, 3, 1, 0, 0, 0, 0, 1, 0, 0, 3, 0, 2, 0, 1, 0, 0, 2, 2, 0, 0, 0, 0, 0, 0, 16, 0, 0, 33, 0, 0, 3, 0, 0, 4, 39, 0, 0, 1, 0, 0, 0, 5, 2, 0, 0, 1, 0, 0, 0, 11, 0, 0, 7, 0, 13, 1, 36, 0, 0, 2, 24, 0, 0, 0, 0, 4, 37, 30, 0, 28, 0, 5, 0, 0, 15, 7, 0, 0, 0, 1, 63, 18, 3, 0, 16, 2, 2, 0, 5, 0, 7, 0, 0, 36, 0, 0, 0, 0, 18, 0, 0, 16, 0, 11, 0, 0, 0, 0, 4, 11, 0, 0, 11, 0, 26, 0, 0, 0, 0, 7, 0, 1, 0, 1, 0, 4, 0, 1, 0, 0, 0, 0, 13, 0, 0, 0, 0, 0, 40, 0, 0, 8, 0, 0, 0, 0, 0, 1, 15, 0, 0, 2, 3, 0, 0, 0, 1, 25, 0, 0, 0, 0, 0, 2, 12, 0, 0, 0, 27, 0, 0, 6, 0, 3, 0, 23, 0, 0, 0, 7, 1, 0, 13, 0, 11, 0, 0, 0, 0, 8, 6, 0, 0, 0, 0, 0, 0, 0, 0, 0, 0, 0, 6, 0, 0, 0, 11, 0, 3, 23, 0, 0, 0, 6, 0, 0, 0, 2, 0, 0, 0, 0, 0, 0, 158, 16, 0, 0, 0, 0, 6, 0, 1, 0, 0, 0, 17, 10, 1, 0, 5, 0, 31, 1, 0, 11, 1, 0, 0, 0, 2, 0, 0, 43, 0, 0, 0, 0, 0, 0, 0, 0, 0, 0, 7, 0, 0, 0, 2, 0, 1, 47, 0, 0, 0, 0, 0, 0, 0, 13, 0, 10, 0, 0, 0, 4, 0, 25, 0, 6, 4, 1, 0, 3, 0, 0, 1, 0, 0, 17, 0, 4, 3, 2, 14, 8, 4, 14, 0, 2, 0, 0, 0, 9, 19, 0, 0, 0, 3, 0, 0, 0, 0, 2, 0, 0, 0, 0, 5, 0, 0, 0, 0, 30, 89, 16, 7, 0, 13, 0, 0, 0, 1, 2, 0, 0, 98, 8, 0, 27, 46, 0, 35, 0, 12, 0, 0, 0, 38, 9, 1, 0, 6, 0, 0, 0, 0, 0, 0, 0, 10, 0, 0, 0, 0, 5, 0, 0, 21, 0, 0, 0, 4, 28, 5, 0, 0, 0, 0, 14, 1, 14, 0, 0, 0, 0, 2, 0, 0, 2, 0, 0, 1, 0, 0, 0, 0, 3, 46, 0, 0, 0, 0, 0, 15, 5, 0, 7, 0, 0, 6, 0, 12, 0, 0, 1, 0, 0, 0, 0, 0, 4, 0, 0, 0, 5, 0, 0, 0, 3, 0, 0, 0, 18, 0, 0, 42, 0, 0, 0, 31, 0, 5, 0, 0, 0, 0, 0, 0, 0, 47, 0, 0, 0, 18, 21, 2, 0, 0, 0, 3, 1, 2, 0, 25, 0, 0, 1, 11, 0, 82, 0, 0, 0, 3, 0, 27, 60, 0, 0, 0, 4, 0, 0, 0, 1, 0, 22, 0, 0, 0, 0, 0, 0, 0, 0, 0, 6, 0, 19, 0, 0, 10, 0, 0, 0, 4, 0, 0, 0, 0, 3, 14, 4, 0, 1, 0, 0, 16, 42, 5, 0, 0, 15, 0, 8, 0, 0, 0, 13, 0, 0, 0, 0, 0, 12, 0, 0, 0, 0, 0, 17, 0, 6, 0, 6, 4, 38, 5, 0, 2, 37, 7, 1, 0, 0, 0, 0, 9, 0, 30, 0, 0, 0, 4, 22, 0, 0, 0, 0, 0, 1, 2, 28, 0, 0, 2, 0, 5, 11, 4, 7, 0, 3, 5, 0, 0, 0, 0, 0, 23, 0, 3, 0, 0, 0, 0, 0, 0, 0, 13, 0, 0, 1, 0, 6, 0, 7, 0, 0, 0, 0, 0, 0, 0, 0, 1, 0, 0, 3, 9, 0, 0, 7, 0, 0, 0, 0, 11, 0, 1, 0, 0, 0, 0, 0, 0, 0, 56, 1, 2, 0, 0, 1, 0, 0, 0, 1, 0, 0, 0, 0, 8, 7, 24, 11, 0, 0, 0, 0, 0, 0, 0, 0, 60, 0, 0, 0, 22, 0, 0, 62, 0, 4, 1, 0, 0, 28, 0, 0, 1, 0, 32, 3, 0, 0, 0, 8, 1, 0, 0, 24, 3, 0, 0, 0, 7, 0, 0, 0, 0, 0, 0, 0, 0, 0, 1, 0, 0, 62, 0, 0, 0, 0, 0, 1, 0, 23, 0, 0, 0, 9, 3, 0, 0, 0, 0, 0, 0, 0, 0, 0, 0, 13, 0, 0, 0, 0, 0, 0, 0, 1, 2, 0, 0, 68, 0, 0, 0, 5, 0, 1, 1, 0, 10, 0, 1, 0, 0, 14, 0, 0, 45, 4, 41, 0, 0, 0, 0, 0, 0, 16, 0, 0, 0, 0, 0, 0, 0, 12, 0, 0, 0, 13, 1, 11, 30, 14, 0, 0, 0, 0, 1, 0, 0, 0, 3, 0, 0, 0, 0, 0, 2, 4, 0, 0, 0, 0, 13, 0, 0, 8, 18, 205, 7, 1, 0, 8, 5, 0, 0, 10, 2, 0, 0, 0, 1, 0, 0, 0, 0, 0, 2, 0, 8, 0, 0, 3, 0, 1, 8, 0, 0, 0, 1, 0, 27, 0, 36, 0, 8, 0, 1, 0, 24, 47, 0, 0, 0, 0, 0, 0, 0, 0, 96, 3, 0, 3, 4, 3, 0, 14, 9, 7, 31, 0, 0, 5, 8, 0, 35, 0, 0, 0, 33, 1, 3, 0, 0, 0, 0, 0, 0, 1, 0, 0, 0, 3, 15, 0, 0, 0, 22, 0, 0, 0, 0, 0, 0, 0, 0, 0, 0, 0, 4, 1, 0, 0, 0, 0, 1, 0, 0, 0, 5, 0, 0, 0, 17, 2, 0, 0, 0, 0, 0, 0, 0, 30, 0, 3, 0, 0, 0, 0, 0, 180, 10, 1, 0, 0, 0, 0, 0, 1, 0, 0, 0, 3, 0, 0, 0, 1, 0, 11, 0, 16, 0, 0, 0, 7, 0, 0, 0, 8, 0, 0, 0, 0, 3, 26, 3, 0, 6, 0, 0, 0, 0, 1, 0, 0, 0, 0, 0, 20, 0, 0, 2, 2, 10, 0, 0, 0, 40, 0, 0, 0, 0, 0, 0, 0, 0, 0, 6, 0, 0, 0, 0, 0, 19, 0, 15, 0, 51, 10, 0, 0, 66, 0, 0, 0, 12, 12, 25, 0, 0, 2, 1, 0, 0, 4, 0, 0, 9, 0, 0, 0, 0, 0, 55, 0, 0, 15, 0, 0, 0, 0, 26, 7, 0, 10, 0, 0, 0, 2, 0, 0, 4, 10, 3, 89, 0, 0, 13, 45, 0, 1, 1, 0, 0, 0, 41, 15, 1, 0, 0, 0, 0, 0, 0, 0, 0, 10, 29, 0, 0, 1, 14, 0, 0, 64, 0, 6, 0, 0, 0, 0, 69, 0, 7, 0, 4, 25, 0, 0, 0, 0, 0, 0, 0, 2, 0, 0, 4, 0, 0, 0, 9, 0, 7, 0, 0, 0, 3, 0, 0, 0, 0, 3, 37, 0, 0, 9, 11, 0, 3, 0, 0, 18, 0, 5, 26, 0, 104, 0, 4, 0, 0, 0, 0, 0, 7, 0, 0, 1, 0, 25, 1, 15, 0, 0, 2, 0, 0, 0, 0, 9, 0, 0, 1, 52, 0, 0, 0, 0, 48, 0, 6, 0, 0, 0, 200, 3, 0, 0, 2, 1, 10, 26, 18, 16
Walt-Disney-An-American-Original-by-Bob-Thomas-_z-lib.org_, 0, 0, 0, 32, 50, 0, 1, 0, 0, 61, 2, 16, 3, 0, 0, 0, 0, 0, 0, 0, 0, 0, 0, 15, 0, 0, 0, 1, 4, 0, 0, 0, 0, 0, 0, 0, 0, 0, 17, 0, 33, 0, 88, 0, 0, 0, 0, 3, 0, 0, 0, 59, 0, 0, 0, 22, 0, 0, 0, 0, 74, 0, 0, 0, 19, 0, 0, 43, 0, 15, 0, 0, 0, 0, 4, 1, 0, 0, 4, 0, 0, 0, 0, 0, 0, 17, 0, 0, 0, 87, 0, 0, 13, 3, 0, 0, 1, 0, 4, 17, 10, 0, 0, 0, 2, 0, 0, 0, 7, 2, 0, 66, 0, 0, 0, 72, 0, 2, 9, 0, 1, 0, 0, 0, 115, 243, 0, 0, 0, 0, 2, 0, 0, 0, 0, 10, 0, 0, 0, 12, 0, 0, 0, 0, 0, 8, 94, 0, 0, 0, 0, 0, 0, 0, 14, 3, 19, 0, 36, 0, 3, 36, 0, 0, 0, 0, 5, 17, 17, 5, 0, 1, 0, 9, 2, 0, 90, 0, 22, 4, 0, 35, 0, 63, 0, 0, 0, 161, 0, 6, 0, 0, 5, 5, 17, 3, 0, 0, 7, 0, 0, 10, 1, 25, 0, 3, 24, 0, 9, 1, 10, 50, 107, 0, 9, 0, 0, 0, 0, 19, 0, 1, 0, 0, 2, 0, 0, 0, 7, 0, 0, 6, 0, 0, 0, 0, 104, 0, 1, 0, 0, 13, 0, 0, 2, 0, 0, 2, 0, 0, 74, 0, 0, 0, 23, 0, 30, 3, 0, 0, 0, 8, 14, 837, 226, 0, 7, 1, 0, 45, 0, 0, 11, 4, 5, 49, 0, 0, 9, 0, 114, 0, 0, 0, 21, 0, 0, 1, 1, 10, 0, 97, 18, 0, 0, 22, 0, 37, 2, 24, 6, 3, 0, 0, 0, 45, 22, 0, 0, 0, 12, 0, 0, 0, 0, 11, 0, 9, 0, 0, 17, 0, 0, 7, 0, 0, 0, 0, 63, 0, 0, 9, 0, 30, 4, 0, 0, 1, 0, 0, 433, 0, 0, 0, 0, 0, 20, 0, 0, 8, 0, 2, 1, 0, 17, 2, 2, 49, 0, 0, 6, 0, 60, 0, 0, 0, 89, 0, 13, 88, 0, 0, 0, 3, 0, 0, 6, 13, 1, 15, 0, 0, 11, 0, 0, 6, 0, 0, 7, 0, 25, 16, 0, 0, 0, 0, 0, 4, 0, 0, 0, 0, 0, 0, 0, 0, 0, 0, 1, 103, 8, 0, 0, 0, 11, 1, 0, 0, 0, 0, 0, 0, 16, 0, 0, 46, 0, 0, 88, 0, 0, 0, 0, 0, 0, 1, 0, 0, 94, 1, 0, 16, 0, 0, 99, 0, 40, 0, 2, 0, 0, 0, 0, 0, 52, 0, 73, 1, 0, 0, 22, 277, 0, 19, 5, 0, 11, 0, 0, 0, 0, 0, 0, 0, 0, 0, 0, 0, 0, 23, 0, 0, 0, 0, 0, 0, 16, 0, 130, 0, 0, 0, 0, 0, 0, 0, 2, 6, 51, 1, 0, 0, 0, 23, 0, 0, 0, 0, 0, 0, 0, 0, 2, 2, 20, 83, 0, 8, 0, 0, 1, 0, 15, 0, 2, 31, 0, 1, 0, 2, 46, 0, 0, 0, 0, 0, 8, 3, 0, 0, 22, 17, 1, 10, 8, 0, 2259, 8, 0, 0, 0, 0, 5, 0, 0, 0, 2, 0, 0, 1, 0, 0, 0, 0, 0, 0, 0, 11, 0, 0, 20, 0, 0, 3, 0, 0, 12, 64, 4, 1, 2, 0, 0, 0, 22, 0, 0, 0, 0, 0, 0, 0, 6, 0, 0, 17, 0, 19, 2, 50, 24, 0, 0, 41, 0, 0, 0, 0, 1, 14, 53, 3, 75, 0, 18, 0, 0, 4, 21, 0, 0, 0, 0, 0, 89, 0, 0, 39, 27, 19, 0, 24, 0, 168, 0, 0, 38, 0, 0, 5, 0, 10, 0, 0, 22, 0, 78, 0, 0, 0, 0, 1, 4, 0, 4, 2, 0, 21, 0, 0, 0, 0, 23, 0, 0, 0, 6, 0, 3, 0, 0, 0, 0, 0, 0, 32, 0, 0, 0, 0, 0, 48, 0, 0, 46, 1, 0, 0, 7, 3, 0, 45, 0, 0, 1, 1, 0, 0, 0, 1, 17, 1, 0, 0, 0, 0, 12, 40, 0, 0, 0, 42, 0, 0, 18, 0, 7, 27, 0, 0, 0, 0, 0, 0, 0, 9, 0, 115, 0, 24, 0, 0, 62, 22, 0, 0, 0, 0, 0, 0, 0, 0, 0, 0, 0, 7, 79, 0, 0, 15, 0, 2, 32, 0, 0, 0, 390, 0, 0, 0, 38, 0, 0, 0, 0, 1, 0, 0, 3, 0, 0, 0, 0, 29, 3, 3, 24, 0, 0, 6, 33, 16, 0, 7, 10, 93, 1, 0, 4, 1, 0, 0, 0, 19, 0, 0, 29, 0, 0, 0, 0, 0, 0, 0, 0, 0, 0, 46, 0, 0, 0, 94, 0, 1, 0, 0, 0, 0, 40, 0, 0, 0, 38, 0, 0, 0, 0, 1, 5, 0, 38, 0, 2, 2, 0, 0, 10, 0, 0, 0, 0, 0, 0, 0, 0, 2, 15, 7, 4, 14, 47, 1, 2, 0, 0, 0, 12, 0, 0, 0, 0, 7, 0, 0, 0, 0, 1, 0, 1, 0, 0, 14, 2, 0, 0, 0, 52, 11, 0, 2, 1, 7, 26, 0, 0, 0, 9, 0, 5, 151, 1, 0, 4, 0, 0, 82, 53, 19, 0, 0, 3, 4, 19, 1, 0, 5, 0, 0, 0, 0, 0, 0, 0, 22, 0, 0, 0, 0, 2, 0, 0, 0, 0, 0, 0, 7, 0, 0, 0, 0, 0, 0, 14, 0, 16, 0, 0, 2, 1, 0, 0, 0, 4, 0, 0, 48, 0, 0, 0, 0, 5, 0, 0, 0, 1, 0, 0, 40, 6, 0, 11, 2, 0, 27, 0, 31, 0, 341, 0, 0, 0, 43, 0, 0, 11, 0, 0, 0, 6, 12, 0, 0, 9, 0, 0, 0, 70, 0, 0, 57, 0, 0, 1, 32, 0, 25, 2, 0, 0, 0, 7, 0, 0, 0, 0, 1, 9, 13, 21, 1, 0, 0, 0, 7, 4, 3, 0, 14, 1, 4, 1, 2, 0, 94, 0, 0, 0, 1, 0, 59, 15, 0, 0, 0, 13, 0, 0, 0, 2, 0, 62, 0, 0, 0, 0, 0, 0, 0, 0, 0, 3, 0, 20, 109, 0, 14, 0, 1, 0, 0, 0, 0, 0, 4, 1, 19, 0, 0, 0, 0, 0, 0, 38, 11, 0, 0, 11, 0, 71, 0, 0, 0, 2, 0, 0, 0, 0, 0, 7, 0, 0, 0, 0, 0, 31, 0, 5, 0, 1, 26, 25, 1, 0, 3, 48, 14, 1, 0, 0, 3, 0, 16, 0, 134, 0, 0, 0, 0, 16, 0, 0, 0, 0, 0, 0, 4, 25, 0, 1, 0, 0, 3, 24, 1, 19, 0, 40, 0, 0, 0, 0, 0, 0, 51, 3, 5, 2, 0, 24, 0, 0, 0, 2, 24, 0, 0, 1, 1, 12, 1, 0, 0, 0, 1, 0, 0, 0, 0, 0, 2, 0, 1, 6, 12, 1, 0, 0, 0, 0, 0, 12, 4, 0, 1, 1, 0, 4, 26, 0, 0, 0, 7, 1, 37, 0, 0, 0, 3, 0, 0, 2, 0, 0, 21, 1, 3, 7, 32, 1, 0, 0, 0, 0, 0, 0, 0, 0, 0, 0, 0, 0, 38, 1, 0, 64, 2, 15, 7, 0, 0, 0, 0, 4, 11, 0, 34, 11, 0, 0, 0, 19, 4, 25, 0, 72, 8, 0, 0, 18, 0, 0, 0, 0, 0, 2, 0, 0, 0, 6, 10, 1, 2, 33, 0, 0, 0, 0, 0, 1, 0, 171, 0, 0, 0, 1, 14, 0, 0, 0, 0, 44, 0, 0, 0, 0, 0, 7, 0, 0, 0, 0, 0, 0, 0, 3, 14, 1, 0, 206, 1, 49, 0, 7, 0, 0, 0, 1, 7, 0, 1, 0, 0, 71, 0, 0, 124, 7, 0, 7, 2, 8, 0, 42, 0, 153, 0, 6, 0, 0, 0, 0, 0, 31, 3, 0, 0, 28, 9, 61, 98, 1, 0, 0, 0, 0, 0, 0, 3, 0, 0, 2, 0, 0, 1, 0, 0, 2, 0, 2, 0, 0, 8, 0, 0, 2, 63, 22, 18, 17, 0, 13, 6, 0, 0, 13, 3, 0, 0, 0, 2, 0, 0, 0, 1, 0, 11, 136, 10, 0, 3, 1, 0, 0, 1, 0, 0, 0, 15, 0, 16, 0, 79, 0, 2, 0, 2, 0, 8, 38, 0, 0, 0, 0, 0, 0, 0, 0, 19, 13, 0, 35, 4, 1, 0, 28, 15, 1, 41, 0, 0, 1, 19, 21, 54, 0, 10, 0, 4, 0, 2, 0, 0, 1, 0, 0, 0, 3, 0, 0, 0, 1, 5, 42, 0, 0, 3, 0, 38, 1, 0, 0, 171, 0, 0, 0, 0, 0, 0, 1, 0, 19, 0, 0, 6, 0, 0, 0, 10, 0, 1, 3, 9, 31, 2, 0, 5, 0, 0, 0, 0, 21, 0, 28, 0, 0, 0, 0, 16, 106, 1, 0, 0, 0, 0, 0, 0, 0, 0, 0, 0, 0, 7, 3, 0, 4, 0, 30, 0, 0, 6, 0, 0, 4, 0, 0, 0, 5, 0, 0, 0, 0, 0, 0, 4, 0, 26, 1, 0, 0, 28, 0, 0, 0, 1, 0, 0, 8, 0, 0, 4, 53, 6, 0, 0, 0, 2, 0, 0, 5, 0, 10, 0, 1, 0, 0, 29, 0, 0, 0, 1, 0, 358, 0, 0, 0, 8, 18, 0, 0, 69, 0, 0, 0, 10, 33, 99, 0, 0, 12, 1, 0, 0, 0, 0, 0, 8, 1, 0, 0, 0, 0, 0, 0, 34, 10, 0, 0, 0, 0, 0, 54, 0, 4, 2, 4, 0, 7, 6, 0, 11, 8, 10, 116, 0, 0, 69, 128, 0, 0, 0, 0, 0, 1, 0, 16, 0, 0, 0, 0, 1, 0, 9, 0, 0, 12, 33, 0, 0, 1, 29, 0, 0, 63, 0, 2, 0, 0, 0, 0, 0, 0, 21, 3, 8, 77, 0, 0, 0, 0, 1, 3, 0, 0, 0, 0, 0, 0, 0, 0, 45, 0, 20, 0, 0, 0, 0, 0, 0, 0, 0, 4, 92, 0, 0, 8, 3, 0, 22, 0, 1, 2, 0, 88, 56, 0, 21, 0, 0, 2, 0, 6, 21, 0, 0, 0, 0, 14, 0, 27, 0, 70, 0, 0, 0, 0, 0, 0, 0, 25, 0, 0, 1, 61, 0, 0, 0, 0, 110, 0, 21, 0, 0, 0, 0, 0, 0, 0, 0, 0, 8, 35, 16, 0
Walt-Disney-The-Triumph-of-the-American-Imagination-by-Neal-Gabler-_z-lib.org_, 0, 0, 0, 44, 230, 0, 43, 0, 0, 55, 3, 38, 3, 1, 0, 0, 1, 0, 0, 0, 0, 0, 0, 22, 0, 0, 0, 1, 9, 0, 0, 0, 0, 0, 0, 0, 0, 1, 67, 0, 51, 0, 194, 0, 0, 0, 0, 2, 0, 0, 0, 140, 0, 0, 0, 20, 0, 0, 0, 0, 91, 0, 0, 0, 74, 0, 0, 49, 0, 32, 0, 0, 0, 0, 9, 7, 0, 0, 27, 0, 0, 0, 0, 0, 0, 188, 0, 10, 0, 142, 3, 0, 40, 2, 0, 0, 0, 0, 6, 6, 18, 0, 0, 0, 0, 0, 0, 0, 16, 1, 0, 79, 1, 2, 0, 41, 0, 6, 10, 0, 4, 0, 0, 0, 218, 403, 0, 0, 0, 0, 6, 0, 0, 0, 0, 37, 1, 0, 0, 15, 0, 0, 0, 0, 1, 19, 160, 0, 0, 0, 0, 0, 44, 0, 8, 22, 22, 0, 128, 4, 9, 89, 0, 0, 2, 0, 62, 55, 14, 13, 0, 1, 0, 33, 13, 0, 158, 0, 31, 22, 0, 116, 0, 40, 0, 0, 0, 335, 0, 9, 0, 0, 1, 13, 38, 0, 0, 4, 9, 0, 0, 11, 0, 81, 1, 0, 17, 0, 22, 2, 36, 179, 102, 0, 22, 0, 1, 0, 0, 32, 0, 0, 0, 1, 19, 0, 0, 0, 10, 0, 0, 8, 0, 0, 0, 0, 328, 0, 3, 0, 4, 16, 2, 0, 1, 0, 0, 0, 1, 0, 53, 0, 0, 0, 51, 0, 113, 23, 0, 0, 0, 5, 20, 1362, 276, 0, 7, 1, 0, 80, 8, 0, 27, 4, 14, 55, 1, 1, 19, 0, 424, 0, 0, 0, 26, 0, 0, 0, 2, 65, 0, 188, 11, 2, 0, 18, 0, 94, 0, 64, 13, 21, 2, 0, 0, 106, 30, 0, 0, 0, 35, 0, 0, 2, 0, 8, 0, 15, 0, 0, 10, 0, 0, 18, 0, 0, 0, 0, 104, 0, 0, 29, 0, 91, 2, 0, 0, 0, 0, 0, 1491, 0, 0, 0, 0, 0, 37, 0, 0, 18, 1, 16, 2, 0, 47, 4, 2, 84, 0, 0, 18, 0, 56, 0, 0, 0, 239, 0, 12, 375, 0, 0, 0, 2, 0, 0, 23, 65, 0, 30, 0, 0, 31, 0, 0, 2, 1, 0, 12, 0, 18, 7, 0, 0, 0, 0, 0, 5, 0, 0, 0, 0, 0, 0, 0, 0, 0, 0, 0, 268, 5, 0, 0, 0, 25, 0, 0, 0, 0, 1, 0, 0, 24, 0, 0, 39, 0, 0, 259, 0, 0, 0, 0, 0, 0, 0, 0, 0, 136, 4, 0, 24, 88, 3, 225, 0, 100, 0, 1, 0, 0, 2, 3, 0, 54, 0, 77, 28, 0, 1, 152, 878, 0, 25, 12, 0, 48, 0, 0, 0, 0, 0, 0, 0, 0, 0, 0, 0, 2, 46, 0, 0, 1, 0, 0, 0, 36, 0, 286, 0, 0, 0, 0, 0, 0, 0, 15, 48, 71, 10, 0, 0, 0, 42, 0, 0, 0, 0, 0, 0, 0, 2, 2, 1, 40, 153, 0, 7, 0, 0, 4, 0, 39, 0, 35, 55, 0, 0, 0, 14, 52, 0, 0, 1, 0, 0, 9, 40, 0, 0, 38, 42, 2, 6, 1, 0, 5160, 13, 0, 6, 0, 0, 7, 0, 0, 0, 36, 0, 0, 21, 0, 0, 0, 0, 0, 0, 0, 15, 0, 0, 62, 0, 0, 20, 0, 0, 49, 122, 10, 3, 2, 0, 0, 0, 24, 4, 0, 0, 0, 0, 0, 0, 24, 0, 0, 14, 0, 10, 10, 64, 107, 0, 0, 34, 0, 0, 0, 0, 6, 11, 169, 12, 93, 0, 42, 0, 0, 11, 23, 0, 0, 5, 2, 0, 281, 1, 0, 76, 43, 23, 0, 34, 0, 322, 0, 0, 60, 0, 0, 5, 0, 25, 0, 0, 101, 0, 71, 2, 0, 0, 0, 2, 3, 0, 3, 2, 0, 23, 0, 0, 0, 0, 72, 0, 1, 0, 1, 0, 8, 0, 0, 0, 0, 0, 1, 37, 0, 1, 0, 0, 0, 99, 0, 0, 88, 6, 0, 0, 23, 5, 0, 96, 0, 0, 2, 1, 0, 0, 0, 1, 11, 3, 0, 0, 0, 0, 37, 42, 0, 0, 0, 99, 0, 0, 39, 0, 18, 12, 0, 0, 6, 0, 1, 0, 0, 65, 0, 177, 0, 36, 0, 0, 268, 40, 0, 0, 0, 0, 0, 0, 0, 0, 0, 0, 0, 23, 146, 0, 0, 127, 0, 4, 76, 0, 0, 0, 767, 0, 0, 0, 94, 0, 0, 0, 0, 0, 0, 0, 10, 0, 1, 0, 0, 35, 7, 2, 17, 0, 0, 10, 31, 76, 0, 15, 26, 253, 1, 0, 19, 5, 0, 0, 0, 18, 0, 0, 56, 0, 0, 0, 0, 0, 0, 0, 0, 3, 1, 47, 0, 0, 0, 133, 0, 5, 0, 0, 0, 0, 37, 0, 0, 0, 59, 0, 3, 0, 0, 10, 16, 0, 95, 0, 39, 6, 1, 0, 26, 0, 0, 0, 0, 0, 0, 0, 2, 1, 19, 41, 31, 35, 34, 0, 14, 0, 0, 0, 19, 1, 0, 0, 0, 11, 0, 0, 0, 1, 28, 0, 1, 0, 0, 21, 2, 1, 0, 0, 114, 35, 1, 6, 0, 17, 29, 2, 0, 0, 19, 0, 2, 209, 11, 0, 12, 19, 0, 218, 144, 55, 2, 0, 4, 8, 32, 0, 0, 14, 0, 0, 0, 0, 0, 0, 0, 77, 0, 0, 0, 0, 8, 0, 0, 0, 0, 0, 1, 20, 0, 1, 0, 1, 0, 0, 8, 4, 58, 0, 0, 6, 3, 0, 0, 2, 11, 0, 0, 43, 0, 0, 0, 0, 6, 0, 0, 0, 1, 0, 0, 96, 15, 0, 37, 5, 0, 29, 0, 24, 0, 471, 2, 0, 0, 28, 0, 0, 21, 0, 0, 0, 15, 30, 0, 0, 45, 0, 0, 0, 119, 0, 0, 164, 0, 0, 0, 63, 0, 34, 5, 0, 0, 0, 2, 0, 0, 0, 0, 8, 8, 66, 22, 10, 0, 0, 0, 13, 8, 6, 0, 30, 14, 52, 4, 3, 0, 175, 0, 0, 0, 6, 0, 157, 17, 0, 0, 0, 32, 0, 0, 0, 2, 0, 142, 0, 0, 0, 0, 0, 0, 0, 0, 0, 4, 0, 68, 621, 0, 30, 1, 0, 0, 3, 0, 1, 0, 0, 4, 44, 4, 1, 0, 0, 0, 0, 151, 9, 0, 0, 35, 0, 59, 0, 0, 0, 10, 0, 0, 0, 0, 0, 12, 0, 0, 0, 0, 0, 67, 0, 18, 0, 0, 28, 32, 6, 0, 0, 90, 26, 4, 0, 0, 18, 0, 21, 0, 214, 3, 0, 0, 3, 28, 0, 0, 0, 0, 0, 1, 10, 36, 0, 1, 0, 26, 3, 73, 5, 21, 0, 87, 0, 0, 0, 0, 0, 0, 173, 10, 36, 2, 0, 90, 0, 0, 0, 2, 37, 0, 0, 3, 1, 57, 0, 0, 0, 0, 7, 0, 0, 0, 0, 0, 2, 0, 4, 7, 10, 2, 0, 0, 0, 0, 0, 2, 18, 0, 0, 0, 0, 5, 133, 0, 0, 0, 5, 2, 24, 0, 0, 9, 6, 0, 0, 3, 0, 0, 25, 2, 6, 14, 112, 1, 0, 0, 0, 0, 0, 0, 0, 0, 0, 0, 0, 0, 60, 2, 0, 203, 1, 21, 8, 0, 0, 0, 0, 2, 12, 0, 63, 16, 0, 0, 0, 39, 17, 135, 0, 98, 7, 0, 0, 21, 0, 0, 0, 0, 0, 8, 0, 0, 0, 6, 17, 1, 12, 61, 0, 0, 0, 0, 0, 0, 0, 355, 0, 0, 0, 4, 18, 0, 0, 0, 0, 194, 0, 0, 3, 0, 0, 20, 0, 0, 0, 1, 0, 0, 0, 19, 7, 0, 0, 245, 2, 46, 0, 7, 0, 1, 0, 8, 27, 0, 1, 1, 0, 86, 0, 0, 398, 6, 0, 4, 0, 11, 0, 41, 0, 238, 0, 13, 0, 0, 0, 0, 0, 56, 24, 0, 0, 40, 16, 118, 99, 26, 0, 0, 0, 1, 1, 0, 4, 0, 3, 1, 0, 0, 0, 0, 0, 1, 0, 0, 1, 0, 17, 0, 0, 8, 197, 76, 74, 39, 4, 45, 7, 0, 0, 22, 10, 0, 0, 0, 0, 0, 0, 0, 1, 0, 18, 587, 17, 0, 22, 3, 0, 0, 0, 0, 0, 0, 9, 0, 43, 0, 127, 0, 17, 0, 3, 0, 10, 108, 4, 0, 0, 0, 0, 0, 0, 0, 16, 27, 0, 93, 24, 1, 0, 26, 29, 9, 50, 0, 0, 6, 22, 292, 249, 0, 11, 0, 14, 0, 13, 0, 1, 3, 0, 0, 0, 13, 0, 0, 0, 6, 20, 46, 0, 0, 17, 0, 45, 4, 0, 0, 502, 3, 0, 0, 0, 0, 9, 2, 0, 15, 0, 0, 13, 3, 3, 0, 25, 0, 4, 4, 16, 29, 1, 0, 13, 0, 0, 0, 0, 110, 5, 19, 0, 1, 0, 6, 89, 168, 1, 2, 0, 0, 0, 0, 0, 4, 0, 0, 2, 0, 16, 7, 0, 4, 0, 41, 0, 0, 31, 0, 0, 9, 1, 2, 0, 28, 0, 0, 0, 1, 6, 0, 6, 0, 42, 2, 0, 0, 25, 0, 0, 15, 0, 0, 0, 40, 0, 0, 1, 48, 5, 0, 0, 0, 1, 0, 0, 6, 0, 9, 0, 1, 0, 0, 68, 0, 0, 0, 1, 0, 978, 2, 4, 0, 37, 18, 0, 0, 93, 0, 0, 0, 22, 59, 141, 0, 0, 16, 2, 0, 0, 1, 0, 0, 29, 2, 0, 0, 0, 0, 0, 0, 134, 13, 0, 0, 0, 0, 0, 121, 1, 21, 2, 0, 0, 45, 12, 0, 15, 25, 6, 239, 0, 0, 144, 215, 0, 0, 0, 0, 0, 2, 14, 44, 2, 0, 0, 0, 3, 0, 18, 0, 0, 16, 75, 0, 0, 3, 25, 0, 0, 155, 1, 23, 0, 0, 0, 0, 0, 6, 68, 1, 21, 127, 2, 0, 0, 2, 0, 0, 0, 1, 9, 0, 0, 1, 0, 0, 51, 2, 89, 0, 0, 0, 9, 0, 0, 0, 1, 7, 146, 0, 0, 15, 5, 0, 36, 0, 1, 5, 0, 145, 144, 0, 15, 0, 2, 7, 0, 12, 7, 0, 5, 0, 0, 9, 0, 34, 0, 200, 0, 0, 1, 0, 0, 0, 0, 59, 0, 0, 12, 206, 3, 0, 0, 0, 185, 0, 26, 0, 1, 0, 0, 0, 0, 0, 1, 1, 28, 245, 32, 0
ALL, 1067, 153, 62, 3062, 4966, 41, 92, 116, 68, 3245, 3572, 1853, 765, 17, 17, 195, 547, 29, 20, 103, 185, 134, 50, 1599, 153, 1035, 64, 190, 697, 207, 84, 37, 77, 241, 1923, 1976, 198, 418, 4273, 63, 1814, 53, 5828, 110, 30, 74, 244, 2203, 118, 75, 13, 3900, 33, 60, 2378, 269, 36, 84, 81, 71, 4785, 114, 94, 349, 2225, 153, 57, 3661, 86, 317, 98, 62, 312, 452, 396, 178, 101, 65, 2441, 320, 54, 294, 47, 39, 130, 2531, 61, 520, 94, 7043, 130, 473, 965, 222, 78, 47, 215, 145, 423, 559, 814, 320, 32, 77, 91, 130, 140, 72, 2417, 66, 72, 1527, 233, 165, 48, 1858, 340, 794, 662, 159, 147, 106, 63, 19, 3055, 10841, 104, 38, 21, 24, 996, 46, 51, 251, 11, 90, 508, 18, 105, 1384, 30, 105, 107, 290, 74, 880, 4355, 211, 123, 21, 28, 50, 324, 46, 1240, 1779, 914, 41, 3405, 800, 158, 2258, 36, 76, 327, 54, 990, 446, 2025, 1257, 319, 477, 269, 2313, 180, 21, 652, 2432, 1854, 2877, 50, 2568, 17, 3160, 20, 39, 43, 1663, 35, 981, 37, 233, 747, 578, 2552, 104, 234, 1180, 1184, 64, 23, 856, 83, 4751, 256, 76, 587, 49, 878, 751, 1461, 2326, 889, 67, 1166, 212, 1412, 180, 56, 952, 26, 74, 49, 68, 704, 75, 23, 47, 417, 691, 258, 317, 113, 325, 37, 46, 1798, 96, 283, 67, 39, 1496, 804, 568, 120, 141, 80, 131, 1506, 599, 2491, 29, 156, 122, 7290, 67, 3165, 190, 235, 38, 24, 899, 843, 5093, 689, 48, 258, 200, 16, 1475, 737, 242, 2137, 453, 2904, 1522, 244, 115, 382, 46, 2553, 45, 45, 45, 1067, 601, 168, 40, 182, 1120, 103, 2012, 764, 498, 474, 757, 142, 2491, 200, 1368, 318, 3255, 214, 12, 59, 5155, 3012, 103, 84, 630, 2186, 40, 357, 218, 309, 1701, 792, 1322, 82, 179, 844, 20, 47, 1102, 102, 163, 30, 132, 3661, 82, 47, 1360, 18, 1413, 342, 57, 84, 433, 24, 130, 2713, 12, 73, 225, 128, 81, 3440, 472, 21, 2918, 171, 1254, 296, 63, 3986, 223, 262, 6822, 39, 97, 1015, 24, 1239, 454, 9, 425, 1280, 249, 1402, 809, 87, 56, 291, 676, 34, 32, 2466, 1054, 240, 4849, 492, 75, 960, 219, 192, 1367, 231, 1817, 845, 111, 2605, 1139, 84, 11, 1170, 18, 226, 218, 46, 165, 68, 26, 216, 168, 144, 140, 13, 129, 70, 4721, 1163, 152, 78, 3959, 759, 45, 654, 17, 193, 81, 37, 31, 382, 1338, 168, 1217, 113, 1176, 4302, 82, 538, 2323, 87, 89, 1660, 31, 476, 76, 3396, 452, 165, 1605, 135, 1086, 5166, 174, 248, 62, 133, 37, 26, 191, 192, 142, 1757, 30, 4383, 1633, 129, 107, 207, 20250, 399, 357, 907, 107, 2699, 241, 22, 400, 26, 16, 306, 21, 87, 114, 702, 161, 102, 2417, 66, 62, 622, 24, 144, 22, 1510, 26, 668, 102, 32, 43, 115, 180, 32, 65, 1657, 417, 1660, 2294, 102, 236, 35, 1548, 47, 91, 56, 1185, 62, 137, 38, 3780, 500, 64, 3956, 4037, 10, 554, 1400, 1130, 287, 61, 2198, 134, 98, 3250, 30, 156, 28, 415, 943, 101, 366, 187, 70, 856, 317, 1672, 48, 1560, 1245, 1402, 152, 598, 590, 211, 8217, 196, 37, 863, 21, 416, 1255, 132, 164, 101, 3285, 48, 135, 911, 1487, 214, 35, 129, 47, 27, 35, 1328, 81, 37, 2426, 199, 26, 987, 33, 26, 882, 3723, 1031, 417, 929, 46, 49, 106, 1247, 1048, 77, 54, 342, 44, 842, 340, 1494, 10, 73, 779, 59, 1601, 150, 2713, 155, 111, 157, 2904, 163, 69, 29, 74, 676, 2189, 2937, 6393, 5051, 105, 1360, 54, 37, 1333, 1183, 73, 182, 471, 123, 63, 3680, 748, 137, 2077, 518, 938, 1099, 2379, 943, 1379, 113, 31, 6393, 167, 31, 554, 94, 3389, 182, 195, 1651, 68, 3542, 236, 92, 38, 334, 145, 1493, 44, 595, 249, 93, 8109, 47, 122, 160, 189, 3395, 346, 326, 81, 1109, 425, 963, 1031, 100, 175, 158, 85, 731, 2160, 5823, 334, 41, 77, 640, 5238, 2973, 73, 2012, 383, 427, 356, 1184, 496, 183, 2370, 43, 31, 762, 532, 219, 104, 65, 269, 4403, 1189, 45, 28, 262, 910, 3774, 1954, 77, 110, 136, 4125, 36, 1888, 2501, 78, 2243, 138, 23, 65, 42, 392, 143, 210, 100, 2591, 26, 697, 388, 1395, 64, 31, 1985, 2554, 51, 111, 314, 312, 380, 51, 32, 49, 67, 24, 183, 875, 520, 222, 501, 2462, 22, 434, 2624, 439, 44, 79, 1579, 11604, 48, 285, 1595, 24, 88, 11, 128, 77, 94, 159, 3032, 26, 167, 9, 57, 2174, 290, 323, 2750, 32, 30, 1090, 1561, 838, 109, 711, 436, 3918, 1348, 29, 2359, 877, 112, 60, 1779, 974, 151, 90, 5182, 144, 209, 86, 153, 40, 237, 84, 130, 135, 49, 1788, 138, 432, 40, 987, 43, 667, 567, 207, 62, 79, 1348, 126, 58, 115, 1352, 161, 1110, 22, 26, 685, 997, 157, 3749, 82, 1306, 1243, 157, 286, 510, 127, 978, 371, 82, 57, 144, 32, 1006, 41, 1924, 1026, 2248, 2992, 1605, 55, 370, 197, 257, 92, 2051, 261, 51, 88, 369, 2299, 46, 123, 166, 120, 454, 165, 239, 308, 25, 2343, 598, 3808, 38, 513, 988, 773, 304, 787, 1025, 1600, 760, 110, 101, 141, 4268, 35, 303, 10356, 1739, 30, 2027, 910, 134, 2193, 246, 1322, 253, 41, 594, 2708, 1204, 40, 503, 526, 63, 91, 90, 65, 74, 451, 162, 5390, 61, 81, 113, 35, 557, 33, 19, 32, 157, 109, 102, 1560, 73, 490, 30, 151, 14, 94, 795, 280, 3172, 102, 27, 464, 629, 726, 58, 147, 2325, 76, 99, 312, 118, 298, 10, 43, 453, 46, 302, 123, 297, 183, 90, 3097, 322, 55, 2271, 271, 32, 663, 121, 1565, 60, 1300, 86, 75, 165, 536, 97, 741, 2621, 139, 27, 60, 4516, 83, 221, 19, 1786, 85, 260, 69, 3617, 28, 20, 3884, 50, 48, 273, 7974, 186, 2944, 490, 14, 103, 100, 107, 191, 491, 47, 136, 141, 259, 1776, 2043, 473, 85, 78, 123, 1311, 437, 309, 10, 1717, 849, 444, 361, 375, 57, 4952, 138, 691, 133, 727, 1048, 3013, 1834, 230, 52, 150, 663, 63, 91, 188, 348, 77, 3526, 110, 69, 16, 130, 30, 131, 229, 56, 21, 453, 58, 4416, 1093, 41, 2053, 172, 138, 74, 2369, 28, 326, 16, 275, 239, 2504, 625, 543, 175, 52, 60, 16, 2958, 499, 52, 99, 3023, 69, 1705, 84, 28, 30, 1320, 362, 48, 49, 15, 245, 2653, 37, 95, 190, 104, 230, 4703, 91, 1023, 93, 835, 720, 11204, 1964, 30, 123, 2803, 2328, 243, 84, 30, 4290, 21, 2349, 97, 5102, 118, 30, 46, 2280, 2396, 43, 62, 104, 156, 40, 295, 1330, 3784, 30, 96, 224, 442, 531, 1662, 499, 1558, 1196, 6322, 1904, 17, 202, 23, 564, 66, 2152, 3136, 1395, 168, 26, 162, 16, 146, 90, 575, 3579, 625, 170, 662, 248, 2465, 258, 397, 236, 21, 437, 36, 301, 934, 52, 55, 204, 34, 58, 961, 1199, 66, 242, 487, 46, 14, 66, 226, 4954, 126, 758, 99, 26, 814, 236, 104, 47, 19, 330, 136, 1949, 577, 9, 1444, 805, 488, 76, 740, 211, 76, 1546, 528, 744, 3450, 5981, 505, 55, 87, 25, 68, 78, 37, 220, 239, 65, 241, 52, 67, 3868, 1702, 252, 3728, 333, 1418, 376, 444, 11, 28, 71, 630, 1282, 76, 1523, 1604, 49, 128, 60, 1163, 448, 257, 98, 1648, 490, 100, 26, 387, 749, 53, 236, 75, 161, 515, 82, 25, 178, 162, 750, 116, 1540, 7236, 28, 152, 99, 43, 55, 240, 81, 4265, 208, 48, 103, 852, 728, 2182, 1086, 208, 286, 521, 780, 48, 121, 34, 59, 6560, 233, 14, 135, 392, 227, 57, 69, 607, 422, 25, 45, 30807, 1375, 133, 83, 3063, 36, 149, 92, 182, 407, 150, 5875, 117, 49, 11833, 390, 43, 6540, 281, 43, 203, 112, 199, 161, 843, 49, 3527, 69, 819, 110, 65, 374, 34, 47, 5015, 282, 59, 34, 2590, 276, 1390, 4678, 1586, 40, 80, 216, 95, 301, 125, 76, 40, 997, 501, 387, 26, 614, 28, 144, 460, 274, 26, 30, 33, 1716, 29, 143, 444, 6673, 2458, 4175, 628, 71, 1457, 671, 434, 80, 2291, 946, 319, 17, 124, 600, 119, 29, 33, 118, 61, 794, 1061, 3225, 75, 861, 849, 76, 200, 2647, 106, 9, 17, 2020, 118, 2054, 18, 3718, 29, 2873, 1332, 832, 420, 1053, 5464, 283, 137, 205, 75, 58, 60, 176, 45, 3802, 5714, 53, 239, 1682, 257, 33, 2102, 1334, 1125, 2481, 68, 56, 440, 2029, 413, 4425, 210, 422, 237, 661, 154, 404, 16, 1315, 194, 71, 269, 37, 678, 612, 106, 114, 2663, 1466, 1057, 121, 22, 1630, 10, 3615, 294, 82, 882, 946, 296, 90, 19, 49, 158, 707, 654, 551, 417, 45, 194, 228, 211, 2534, 82, 1178, 494, 785, 220, 1773, 1593, 143, 20, 652, 228, 243, 110, 412, 1659, 313, 1267, 166, 133, 49, 257, 116, 18227, 2353, 642, 153, 198, 28, 120, 1082, 3208, 116, 157, 75, 600, 285, 776, 346, 320, 33, 1518, 78, 16, 920, 215, 11, 1244, 62, 187, 26, 889, 56, 70, 94, 292, 81, 50, 465, 44, 1899, 452, 54, 177, 446, 190, 25, 151, 266, 19, 12, 2070, 20, 15, 517, 641, 661, 3951, 256, 76, 131, 54, 529, 1791, 13, 819, 133, 68, 57, 91, 1850, 96, 96, 43, 556, 104, 1915, 319, 1017, 294, 2318, 1140, 1184, 78, 3505, 166, 131, 58, 4330, 2016, 3253, 22, 1442, 732, 387, 51, 61, 303, 69, 49, 2771, 438, 48, 54, 27, 94, 55, 91, 257, 1895, 93, 2007, 19, 145, 26, 1372, 976, 421, 178, 161, 96, 1222, 165, 59, 734, 593, 3633, 6413, 44, 26, 4242, 3848, 42, 143, 2942, 214, 20, 750, 1043, 1165, 374, 37, 35, 117, 716, 43, 310, 390, 390, 2902, 2593, 374, 1065, 189, 1271, 687, 57, 4183, 280, 1701, 134, 9, 133, 24, 69, 202, 4061, 238, 4123, 2509, 174, 25, 86, 477, 169, 621, 159, 972, 6160, 21, 130, 69, 21, 257, 2559, 238, 2223, 94, 30, 90, 1187, 88, 32, 53, 422, 863, 2589, 1157, 292, 1246, 476, 144, 1550, 63, 231, 814, 60, 3131, 5662, 81, 815, 422, 943, 700, 18, 657, 424, 11, 1084, 60, 38, 337, 586, 2372, 159, 1162, 47, 58, 483, 5380, 30, 106, 97, 1196, 1075, 439, 468, 6449, 73, 15, 29, 536, 4388, 88, 2148, 178, 83, 59, 203, 130, 820, 21, 500, 224, 1281, 4351, 1913, 357
出现次数, 1, 2, 2, 60, 59, 1, 3, 4, 2, 60, 26, 57, 35, 4, 1, 16, 42, 6, 1, 4, 1, 6, 5, 59, 15, 1, 1, 12, 49, 29, 6, 1, 26, 15, 7, 4, 6, 33, 60, 1, 60, 4, 58, 9, 5, 2, 3, 50, 15, 2, 1, 60, 1, 3, 7, 22, 3, 2, 4, 6, 60, 13, 9, 7, 57, 3, 2, 60, 11, 43, 7, 4, 9, 6, 39, 19, 8, 1, 59, 1, 4, 2, 1, 1, 1, 56, 1, 35, 1, 60, 22, 5, 58, 23, 2, 2, 22, 20, 50, 47, 36, 9, 3, 2, 6, 1, 12, 6, 51, 10, 3, 60, 5, 14, 2, 59, 8, 42, 36, 3, 18, 11, 12, 1, 56, 60, 19, 3, 3, 5, 51, 2, 11, 10, 1, 3, 19, 3, 2, 54, 1, 15, 3, 6, 17, 55, 60, 1, 12, 1, 8, 10, 32, 1, 56, 58, 49, 5, 60, 41, 22, 60, 2, 1, 33, 2, 56, 45, 57, 47, 5, 29, 9, 60, 31, 1, 33, 12, 59, 56, 3, 60, 1, 60, 1, 2, 4, 58, 2, 53, 1, 7, 49, 46, 60, 30, 7, 38, 59, 4, 6, 47, 11, 60, 16, 10, 53, 8, 54, 47, 60, 60, 47, 6, 52, 1, 14, 7, 1, 56, 1, 7, 2, 2, 48, 2, 1, 2, 39, 11, 17, 25, 3, 5, 1, 2, 59, 2, 30, 8, 4, 59, 48, 25, 23, 1, 1, 21, 26, 8, 60, 1, 2, 5, 60, 2, 60, 21, 2, 2, 3, 56, 54, 27, 8, 1, 39, 16, 2, 58, 51, 1, 59, 49, 60, 57, 34, 18, 30, 3, 56, 1, 1, 1, 54, 7, 2, 7, 34, 56, 10, 60, 50, 29, 19, 50, 4, 60, 39, 59, 33, 56, 21, 1, 1, 60, 59, 5, 2, 34, 60, 2, 7, 11, 27, 55, 5, 52, 2, 20, 57, 1, 1, 60, 7, 2, 1, 1, 60, 1, 1, 60, 1, 56, 43, 3, 3, 10, 1, 2, 34, 2, 1, 1, 2, 1, 60, 26, 1, 54, 11, 54, 44, 4, 58, 17, 12, 60, 1, 1, 60, 1, 39, 21, 1, 10, 57, 5, 59, 35, 1, 8, 31, 50, 1, 3, 56, 47, 27, 60, 4, 3, 51, 13, 7, 55, 28, 7, 57, 1, 50, 58, 3, 2, 4, 1, 8, 30, 9, 3, 1, 1, 6, 8, 12, 4, 1, 19, 7, 58, 55, 9, 5, 19, 53, 14, 11, 2, 4, 10, 5, 1, 38, 20, 3, 54, 9, 4, 60, 2, 5, 37, 1, 21, 23, 5, 26, 20, 60, 49, 11, 59, 2, 39, 60, 5, 16, 2, 7, 1, 1, 28, 30, 17, 52, 6, 60, 58, 13, 11, 6, 60, 17, 36, 47, 2, 59, 1, 1, 9, 4, 2, 6, 1, 3, 1, 7, 1, 15, 58, 2, 8, 41, 4, 8, 1, 53, 4, 32, 3, 1, 1, 3, 16, 2, 1, 46, 47, 59, 52, 1, 22, 1, 60, 3, 1, 1, 7, 2, 1, 1, 31, 42, 11, 60, 59, 1, 52, 15, 14, 15, 7, 60, 8, 5, 60, 3, 37, 4, 49, 58, 5, 5, 19, 1, 23, 42, 60, 2, 12, 53, 50, 12, 46, 30, 6, 20, 16, 1, 32, 1, 31, 53, 5, 5, 1, 58, 5, 7, 55, 45, 5, 1, 9, 2, 2, 2, 55, 5, 1, 60, 12, 3, 52, 2, 5, 42, 58, 17, 16, 49, 8, 2, 7, 40, 44, 1, 1, 25, 1, 7, 19, 58, 1, 2, 60, 7, 58, 14, 59, 3, 1, 23, 60, 1, 1, 1, 1, 47, 58, 59, 28, 59, 11, 58, 7, 2, 60, 52, 1, 3, 48, 19, 1, 59, 34, 1, 60, 45, 57, 11, 60, 6, 56, 5, 1, 59, 5, 2, 41, 6, 60, 5, 6, 51, 1, 60, 21, 2, 1, 18, 10, 56, 2, 33, 36, 9, 56, 7, 11, 5, 10, 60, 7, 32, 3, 52, 1, 51, 1, 15, 1, 12, 1, 43, 60, 30, 19, 1, 3, 16, 59, 6, 1, 59, 46, 17, 11, 50, 47, 7, 60, 1, 2, 48, 55, 16, 6, 2, 31, 57, 48, 5, 1, 2, 4, 59, 60, 1, 9, 2, 60, 1, 10, 59, 13, 60, 10, 1, 3, 9, 33, 10, 14, 1, 60, 5, 42, 17, 56, 1, 2, 55, 58, 1, 8, 2, 1, 20, 2, 1, 2, 9, 3, 4, 60, 26, 1, 17, 58, 1, 50, 60, 8, 3, 2, 24, 20, 9, 2, 57, 8, 3, 2, 10, 7, 7, 2, 60, 2, 26, 1, 1, 60, 36, 48, 57, 1, 2, 57, 56, 50, 1, 55, 31, 60, 53, 5, 60, 51, 1, 10, 5, 52, 9, 5, 60, 7, 11, 1, 3, 3, 1, 5, 1, 6, 7, 60, 6, 13, 1, 47, 4, 39, 14, 1, 2, 1, 58, 3, 2, 4, 57, 1, 37, 2, 1, 50, 59, 5, 55, 3, 56, 55, 13, 17, 29, 20, 10, 27, 19, 1, 22, 2, 37, 13, 47, 58, 59, 60, 59, 8, 46, 7, 6, 1, 59, 12, 8, 6, 11, 57, 1, 1, 2, 17, 53, 1, 21, 1, 5, 57, 43, 30, 2, 8, 46, 47, 35, 48, 37, 60, 49, 10, 1, 20, 51, 3, 35, 60, 58, 1, 49, 30, 2, 60, 5, 58, 28, 3, 41, 58, 59, 15, 12, 57, 2, 4, 15, 5, 1, 10, 2, 58, 2, 2, 7, 1, 41, 2, 1, 7, 2, 9, 24, 57, 13, 34, 1, 25, 1, 8, 54, 25, 60, 1, 5, 37, 35, 37, 2, 26, 60, 2, 1, 23, 7, 2, 1, 1, 51, 1, 2, 16, 50, 12, 4, 58, 39, 1, 60, 35, 1, 53, 6, 57, 2, 32, 15, 4, 1, 49, 11, 5, 53, 6, 1, 1, 59, 3, 7, 2, 58, 4, 11, 21, 60, 3, 1, 60, 9, 1, 32, 60, 3, 60, 35, 1, 2, 4, 27, 9, 11, 1, 12, 18, 33, 57, 60, 52, 3, 4, 6, 57, 41, 42, 1, 51, 56, 27, 46, 30, 2, 60, 5, 13, 12, 28, 4, 60, 54, 18, 2, 16, 53, 9, 1, 2, 50, 1, 60, 2, 1, 1, 27, 6, 2, 22, 3, 2, 50, 1, 59, 15, 1, 58, 20, 14, 2, 53, 2, 38, 2, 32, 43, 59, 42, 18, 24, 1, 1, 1, 60, 39, 1, 3, 60, 3, 56, 3, 1, 1, 53, 7, 1, 4, 1, 16, 60, 1, 1, 3, 4, 7, 59, 2, 58, 3, 28, 53, 60, 52, 1, 20, 60, 59, 36, 1, 1, 32, 1, 60, 3, 54, 14, 3, 4, 59, 60, 3, 1, 5, 3, 2, 31, 40, 60, 2, 15, 27, 4, 37, 59, 47, 60, 22, 58, 46, 1, 1, 1, 45, 1, 59, 55, 56, 24, 1, 4, 1, 2, 1, 51, 60, 16, 6, 43, 20, 58, 8, 11, 25, 1, 11, 1, 12, 2, 7, 1, 21, 1, 10, 53, 60, 19, 4, 21, 1, 1, 1, 36, 60, 3, 48, 12, 4, 11, 5, 4, 2, 1, 37, 29, 60, 13, 1, 52, 36, 7, 1, 54, 18, 2, 57, 14, 54, 56, 60, 26, 2, 2, 1, 3, 2, 3, 21, 24, 3, 1, 5, 11, 60, 47, 1, 60, 45, 60, 40, 22, 1, 1, 5, 42, 60, 1, 60, 46, 1, 1, 2, 60, 46, 3, 2, 59, 47, 1, 1, 41, 38, 2, 15, 3, 1, 54, 6, 1, 3, 37, 46, 37, 51, 60, 1, 4, 13, 2, 2, 24, 5, 59, 6, 2, 2, 54, 58, 9, 4, 2, 6, 35, 11, 3, 18, 1, 13, 54, 10, 2, 1, 12, 19, 1, 1, 49, 30, 3, 3, 60, 56, 6, 1, 59, 2, 18, 6, 22, 52, 25, 43, 7, 4, 60, 23, 4, 58, 50, 3, 36, 24, 35, 1, 41, 3, 60, 8, 13, 10, 2, 31, 1, 2, 60, 31, 3, 2, 58, 40, 52, 60, 58, 4, 1, 3, 3, 19, 12, 19, 1, 37, 34, 11, 1, 26, 2, 12, 31, 1, 8, 6, 2, 58, 1, 3, 38, 60, 59, 57, 29, 15, 59, 53, 9, 1, 59, 59, 9, 2, 2, 52, 1, 1, 6, 10, 2, 48, 7, 56, 2, 57, 46, 5, 13, 55, 4, 1, 2, 49, 16, 59, 3, 59, 2, 60, 5, 45, 4, 54, 60, 15, 8, 1, 1, 4, 2, 15, 7, 52, 58, 2, 17, 59, 18, 4, 58, 59, 53, 59, 1, 3, 42, 60, 11, 60, 1, 33, 2, 30, 9, 46, 1, 53, 31, 1, 1, 4, 56, 23, 2, 1, 58, 57, 49, 1, 1, 60, 2, 58, 27, 4, 6, 16, 39, 3, 1, 1, 3, 41, 39, 20, 44, 1, 5, 14, 16, 54, 16, 58, 2, 28, 29, 57, 55, 7, 1, 45, 4, 2, 19, 13, 54, 31, 56, 16, 14, 3, 38, 3, 60, 53, 45, 4, 2, 1, 2, 17, 50, 1, 5, 21, 42, 26, 53, 11, 31, 2, 55, 2, 1, 24, 7, 1, 58, 14, 36, 1, 60, 3, 1, 1, 28, 20, 10, 31, 2, 59, 23, 4, 1, 36, 3, 4, 15, 6, 3, 1, 57, 1, 2, 32, 45, 52, 2, 21, 1, 18, 9, 15, 33, 2, 37, 13, 13, 1, 14, 58, 12, 1, 3, 22, 6, 46, 28, 46, 16, 57, 58, 19, 4, 59, 10, 2, 13, 60, 58, 60, 6, 12, 38, 45, 9, 5, 44, 6, 1, 60, 43, 1, 1, 2, 2, 1, 2, 5, 55, 1, 38, 1, 4, 1, 60, 29, 51, 15, 18, 1, 53, 23, 3, 49, 38, 47, 60, 2, 4, 60, 60, 4, 10, 25, 2, 1, 37, 33, 60, 29, 3, 3, 15, 43, 2, 17, 19, 7, 60, 60, 5, 4, 27, 59, 13, 10, 60, 20, 54, 3, 1, 2, 3, 1, 22, 60, 24, 58, 60, 23, 2, 11, 9, 25, 46, 1, 48, 25, 1, 11, 16, 1, 9, 60, 14, 60, 3, 1, 4, 55, 4, 1, 1, 23, 55, 59, 10, 5, 54, 28, 3, 59, 8, 10, 25, 2, 60, 60, 12, 52, 24, 54, 47, 1, 48, 46, 2, 49, 1, 1, 38, 23, 60, 10, 58, 1, 3, 49, 12, 1, 6, 7, 60, 7, 4, 49, 59, 3, 1, 6, 33, 60, 4, 60, 2, 20, 1, 3, 9, 1, 2, 43, 18, 58, 60, 60, 30
